氏	family name/surname/clan	
統	overall/relationship/ruling/governing	
保	protect/guarantee/keep/preserve/sustain/support	
第	No./residence	
結	tie/bind/contract/join/organize/do up hair/fasten	
派	faction/group/party/clique/sect/school	
案	plan/suggestion/draft/ponder/fear/proposition/idea/expectation/bill/worry	
策	scheme/plan/policy/step/means	
基	fundamentals/radical (chem)/counter for machines/foundation	
価	value/price	
提	propose/take along/carry in hand	
挙	raise/plan/project/behavior/actions	
応	apply/answer/yes/OK/reply/accept	
企	undertake/scheme/design/attempt/plan	
検	examination/investigate	
藤	wisteria	
沢	swamp	
裁	tailor/judge/decision/cut out (pattern)	
証	evidence/proof/certificate	
援	abet/help/save	
施	alms/apply bandages/administer first-aid	
井	well/well crib/town/community	
護	safeguard/protect	
展	unfold/expand	
態	attitude/condition/figure/appearance/voice (of verbs)	
鮮	fresh/vivid/clear/brilliant/Korea	
視	inspection/regard as/see/look at	
条	article/clause/item/stripe/streak	
幹	tree trunk	
独	single/alone/spontaneously/Germany	
宮	Shinto shrine/constellations/palace/princess	
率	ratio/rate/proportion/%/coefficient/factor	
衛	defense/protection	
張	lengthen/counter for bows & stringed instruments/stretch/spread/put up (tent)	
監	oversee/official/govt office/rule/administer	
環	ring/circle/link/wheel	
審	hearing/judge/trial	
義	righteousness/justice/morality/honor/loyalty/meaning	
訴	accusation/sue/complain of pain/appeal to	
株	stocks/stump/shares/stock/counter for small plants	
姿	figure/form/shape	
閣	tower/tall building/palace	
衆	masses/great numbers/multitude/populace	
評	evaluate/criticism/comment	
影	shadow/silhouette/phantom	
松	pine tree	
撃	beat/attack/defeat/conquer	
佐	assistant/help	
核	nucleus/core/kernel	
整	organize/arranging/tune/tone/meter/key (music)	
融	dissolve/melt	
製	made in.../manufacture	
票	ballot/label/ticket/sign	
渉	ford/ferry/port	
響	echo/also N5116/sound/resound/ring/vibrate	
推	conjecture/infer/guess/suppose/support	
請	solicit/invite/ask	
器	utensil/vessel/receptacle/implement/instrument/ability/container/tool/set	
士	gentleman/samurai	
討	chastise/attack/defeat/destroy/conquer	
攻	aggression/attack	
崎	promontory/cape/spit	
督	coach/command/urge/lead/supervise	
授	impart/instruct/grant/confer	
催	sponsor/hold (a meeting)/give (a dinner)	
及	reach out/exert/exercise/cause	
憲	constitution/law	
離	detach/separation/disjoin/digress	
激	violent/get excited/enraged/chafe/incite	
摘	pinch/pick/pluck/trim/clip/summarize	
系	lineage/system	
批	criticism/strike	
郎	son/counter for sons	
健	healthy/health/strength/persistence	
盟	alliance/oath	
従	accompany/obey/submit to/comply/follow/secondary/incidental/subordinate	
修	discipline/conduct oneself well/study/master	
隊	regiment/party/company/squad	
織	weave/fabric	
拡	broaden/extend/expand/enlarge	
故	happenstance/especially/intentionally/reason/cause/circumstances/the late/therefore/consequently	
振	shake/wave/wag/swing	
弁	valve/petal/braid/speech/dialect/discrimination/dispose of/distinguish	
就	concerning/settle/take position/depart/study/per	
異	uncommon/queerness/strangeness/wonderful/curious/unusual	
献	offering/counter for drinks/present/offer	
厳	stern/strictness/severity/rigidity	
維	fiber/tie/rope	
浜	seacoast/beach/seashore	
遺	bequeath/leave behind/reserve	
塁	bases/fort/rampart/walls/base(ball)	
邦	home country/country/Japan	
素	elementary/principle/naked/uncovered	
遣	despatch/send/give/donate/do/undertake	
抗	confront/resist/defy/oppose	
模	imitation/copy/mock	
雄	masculine/male/hero/leader/superiority/excellence	
益	benefit/gain/profit/advantage	
緊	tense/solid/hard/reliable/tight	
標	signpost/seal/mark/stamp/imprint/symbol/emblem/trademark/evidence/souvenir/target	
宣	proclaim/say/announce	
昭	shining/bright	
廃	abolish/obsolete/cessation/discarding/abandon	
伊	Italy/that one	
江	creek/inlet/bay	
僚	colleague/official/companion	
吉	good luck/joy/congratulations	
盛	boom/prosper/copulate	
皇	emperor	
臨	look to/face/meet/confront/attend/call on	
踏	step/trample/carry through/appraise/evade payment	
壊	demolition/break/destroy	
債	bond/loan/debt	
興	entertain/revive/retrieve/interest/pleasure	
源	source/origin	
儀	ceremony/rule/affair/case/a matter	
創	genesis/wound/injury/hurt/start/originate	
障	hinder/hurt/harm	
継	inherit/succeed/patch/graft (tree)	
筋	muscle/sinew/tendon/fiber/plot/plan/descent	
闘	fight/war	
葬	interment/bury/shelve	
避	evade/avoid/avert/ward off/shirk/shun	
司	director/official/govt office/rule/administer	
康	ease/peace	
善	virtuous/good/goodness	
逮	apprehend/chase	
迫	urge/force/imminent/spur on	
惑	beguile/delusion/perplexity	
崩	crumble/die/demolish/level	
紀	chronicle/account/narrative/history/annals/geologic period	
聴	listen/headstrong/naughty/careful inquiry	
脱	undress/removing/escape from/get rid of/be left out/take off	
級	class/rank/grade	
博	Dr./command/esteem/win acclaim/Ph.D./exposition/fair	
締	tighten/tie/shut/lock/fasten	
救	salvation/save/help/rescue/reclaim	
執	tenacious/take hold/grasp/take to heart	
房	tassel/tuft/fringe/bunch/lock (hair)/segment (orange)/house/room	
撤	remove/withdraw/disarm/dismantle/reject/exclude	
削	plane/sharpen/whittle/pare	
密	secrecy/density (pop)/minuteness/carefulness	
措	set aside/give up/suspend/discontinue/lay aside/except	
志	intention/plan/resolve/aspire/motive/hopes/shilling	
載	ride/board/get on/place/spread/10**44	
陣	camp/battle array/ranks/position	
我	ego/I/selfish/our/oneself	
為	do/change/make/benefit/welfare/be of use/reach to/try/practice/cost/serve as/good/advantage/as a re	
抑	repress/well/now/in the first place/push/shove/press/seal/do in spite of	
幕	curtain/bunting/act of play	
染	dye/color/paint/stain/print	
奈	Nara/what?	
傷	wound/hurt/injure/impair/pain/injury/cut/gash/scar/weak point	
択	choose/select/elect/prefer	
秀	excel/excellence/beauty/surpass	
徴	indications/sign/omen/symptom/collect/seek/refer to/question	
弾	bullet/twang/flip/snap	
償	reparation/make up for/recompense/redeem	
功	achievement/merits/success/honor/credit	
拠	foothold/based on/follow/therefore	
秘	secret/conceal	
拒	repel/refuse/reject/decline	
刑	punish/penalty/sentence/punishment	
塚	hillock/mound	
致	doth/do/send/forward/cause/exert/incur/engage	
繰	winding/reel/spin/turn (pages)/look up/refer to	
尾	tail/end/counter for fish/lower slope of mountain	
描	sketch/compose/write/draw/paint	
鈴	small bell/buzzer	
盤	tray/shallow bowl/platter/tub/board/phonograph record	
項	paragraph/nape of neck/clause/item/term (expression)	
喪	miss/mourning	
伴	consort/accompany/bring with/companion	
養	foster/bring up/rear/develop/nurture	
懸	suspend/hang/10%/install/depend/consult	
街	boulevard/street/town	
契	pledge/promise/vow	
掲	put up (a notice)/put up/hoist/display/hang out/publish/describe	
躍	leap/dance/skip	
棄	abandon/throw away/discard/resign/reject/sacrifice	
邸	residence/mansion	
縮	shrink/contract/shrivel/wrinkle/reduce	
還	send back/return	
属	belong/genus/subordinate official/affiliated	
慮	prudence/thought/concern/consider/deliberate/fear	
枠	frame/framework/spindle/spool/bounding-box/(kokuji)	
恵	favor/blessing/grace/kindness	
露	dew/tears/expose/Russia	
沖	open sea/offing/rise high into sky	
緩	slacken/loosen/relax/lessen/be moderate/ease	
節	node/season/period/occasion/verse/clause/stanza/honor/joint/knuckle/knob/knot/tune/melody	
需	demand/request/need	
射	shoot/shine into/onto/archery	
購	subscription/buy	
揮	brandish/wave/wag/swing/shake	
充	allot/fill	
貢	tribute/support/finance	
鹿	deer	
却	instead/on the contrary/rather	
端	edge/origin/end/point/border/verge/cape	
賃	fare/fee/hire/rent/wages/charge	
獲	seize/get/find/earn/acquire/can/may/able to	
郡	county/district	
併	join/get together/unite/collective	
徹	penetrate/clear/pierce/strike home/sit up (all night)	
貴	precious/value/prize/esteem/honor	
衝	collide/brunt/highway/opposition (astronomy)/thrust/pierce/stab/prick	
焦	char/hurry/impatient/irritate/burn/scorch/singe	
奪	rob/take by force/snatch away/dispossess/plunder/usurp	
災	disaster/calamity/woe/curse/evil	
浦	bay/creek/inlet/gulf/beach/seacoast	
析	chop/divide/tear/analyze	
譲	defer/turnover/transfer/convey	
称	appellation/praise/admire/name/title/fame	
納	settlement/obtain/reap/pay/supply/store	
樹	timber trees/wood	
挑	challenge/contend for/make love to	
誘	entice/lead/tempt/invite/ask/call for/seduce/allure	
紛	distract/be mistaken for/go astray/divert	
至	climax/arrive/proceed/reach/attain/result in	
宗	religion/sect/denomination/main point/origin/essence	
促	stimulate/urge/press/demand/incite	
慎	humility/be careful/discrete/prudent	
控	withdraw/draw in/hold back/refrain from/be moderate	
智	wisdom/intellect/reason	
握	grip/hold/mould sushi/bribe	
宙	mid-air/air/space/sky/memorization/interval of time	
俊	sagacious/genius/excellence	
銭	coin/.01 yen/money	
渋	astringent/hesitate/reluctant/have diarrhea	
銃	gun/arms	
操	maneuver/manipulate/operate/steer/chastity/virginity/fidelity	
携	portable/carry (in hand)/armed with/bring along	
診	checkup/seeing/diagnose/examine	
託	consign/requesting/entrusting with/pretend/hint	
撮	snapshot/take pictures	
誕	nativity/be born/declension/lie/be arbitrary	
侵	encroach/invade/raid/trespass/violate	
括	fasten/tie up/arrest/constrict	
謝	apologize/thank/refuse	
駆	drive/run/gallop/advance/inspire/impel	
透	transparent/permeate/filter/penetrate	
津	haven/port/harbor/ferry	
壁	wall/lining (stomach)/fence	
稲	rice plant	
仮	sham/temporary/interim/assumed (name)/informal	
裂	split/rend/tear	
敏	cleverness/agile/alert	
是	just so/this/right/justice	
排	repudiate/exclude/expel/reject	
裕	abundant/rich/fertile	
堅	strict/hard/solid/tough/tight/reliable	
訳	translate/reason/circumstance/case	
芝	turf/lawn	
綱	hawser/class (genus)/rope/cord/cable	
典	code/ceremony/law/rule	
賀	congratulations/joy	
扱	handle/entertain/thresh/strip	
顧	look back/review/examine oneself/turn around	
弘	vast/broad/wide	
看	watch over/see	
訟	sue/accuse	
戒	commandment	
祉	welfare/happiness	
誉	reputation/praise/honor/glory	
歓	delight/joy	
奏	play music/speak to a ruler/complete	
勧	persuade/recommend/advise/encourage/offer	
騒	boisterous/make noise/clamor/disturb/excite	
閥	clique/lineage/pedigree/faction/clan	
甲	armor/high (voice)/A grade/first class/former/instep/carapace	
縄	straw rope/cord	
郷	home town/village/native place/district	
揺	swing/shake/sway/rock/tremble/vibrate	
免	excuse/dismissal	
既	previously/already/long ago	
薦	recommend/mat/advise/encourage/offer	
隣	neighboring	
華	splendor/flower/petal/shine/luster/ostentatious/showy/gay/gorgeous	
範	pattern/example/model	
隠	conceal/hide/cover	
徳	benevolence/virtue/goodness/commanding respect	
哲	philosophy/clear	
杉	cedar/cryptomeria	
釈	explanation	
己	self/snake/serpent	
妥	gentle/peace/depravity	
威	intimidate/dignity/majesty/menace/threaten	
豪	overpowering/great/powerful/excelling/Australia	
熊	bear	
滞	stagnate/be delayed/overdue/arrears	
微	delicate/minuteness/insignificance	
隆	hump/high/noble/prosperity	
症	symptoms/illness	
暫	temporarily/a while/moment/long time	
忠	loyalty/fidelity/faithfulness	
倉	godown/warehouse/storehouse/cellar/treasury	
彦	lad/boy (ancient)	
肝	liver/pluck/nerve/chutzpah	
喚	yell/cry/scream	
沿	run alongside/follow along/run along/lie along	
妙	exquisite/strange/queer/mystery/miracle/excellent/delicate/charming	
唱	chant/recite/call upon/yell	
阿	Africa/flatter/fawn upon/corner/nook/recess	
索	cord/rope	
誠	sincerity/admonish/warn/prohibit/truth/fidelity	
襲	attack/advance on/succeed to/pile/heap	
懇	sociable/kind/courteous/hospitable/cordial	
俳	haiku/actor	
柄	design/pattern/build/nature/handle/crank/grip/knob/shaft	
驚	wonder/be surprised/frightened/amazed	
麻	hemp/flax	
李	plum	
浩	wide expanse/abundance/vigorous	
剤	dose/medicine/drug	
瀬	rapids/current/torrent/shallows/shoal	
趣	gist/proceed to/tend/become	
陥	collapse/fall into/cave in/fall (castle)/slide into	
斎	purification/Buddhist food/room/worship/avoid/alike	
貫	pierce/8 1/3lbs/penetrate/brace	
仙	hermit/wizard/cent	
慰	consolation/amusement/seduce/cheer/make sport of/comfort/console	
序	preface/beginning/order/precedence/occasion/chance/incidentally	
旬	decameron/10day period/season (for specific products	
兼	concurrently/and	
聖	holy/saint/sage/master/priest	
旨	delicious/relish/show a liking for/purport/will/clever/expert	
即	instant/namely/as is/conform/agree/adapt	
柳	willow	
舎	cottage/inn/hut/house/mansion	
偽	falsehood/lie/deceive/pretend/counterfeit/forgery	
較	contrast/compare	
覇	hegemony/supremacy/leadership/champion	
詳	detailed/full/minute/accurate/well-informed	
抵	resist/reach/touch	
脅	threaten/coerce	
茂	overgrown/grow thick/be luxuriant	
犠	sacrifice	
旗	national flag/banner/standard	
距	long-distance	
雅	gracious/elegant/graceful/refined	
飾	decorate/ornament/adorn/embellish	
網	netting/network	
竜	dragon/imperial	
詩	poem/poetry	
繁	luxuriant/thick/overgrown/frequency/complexity/trouble	
翼	wing/plane/flank	
潟	lagoon	
敵	enemy/foe/opponent	
魅	fascination/charm/bewitch	
嫌	dislike/detest/hate	
斉	adjusted/alike/equal/similar variety of	
敷	spread/pave/sit/promulgate	
擁	hug/embrace/possess/protect/lead	
圏	sphere/circle/radius/range	
酸	acid/bitterness/sour/tart	
滅	destroy/ruin/overthrow/perish	
罰	penalty/punishment	
礎	cornerstone/foundation stone	
腐	rot/decay/sour	
脚	skids/leg/undercarriage	
潮	tide/salt water/opportunity	
梅	plum	
尽	exhaust/use up/run out of/befriend/serve	
僕	me/I (male)	
桜	cherry	
滑	slippery/slide/slip/flunk	
孤	orphan/alone	
炎	inflammation/flame/blaze	
賠	compensation/indemnify	
句	phrase/clause/sentence/passage/paragraph/counter for haiku	
鋼	steel	
頑	stubborn/foolish/firmly	
鎖	chain/irons/connection	
彩	coloring/paint/makeup	
摩	chafe/rub/polish/grind/scrape	
励	encourage/be diligent/inspire	
縦	vertical/length/height/self-indulgent/wayward	
輝	radiance/shine/sparkle/gleam/twinkle	
蓄	amass/keeping a concubine/phonograph	
軸	axis/pivot/stem/stalk/counter for book scrolls	
巡	patrol/go around/circumference	
稼	earnings/work/earn money	
瞬	wink/blink/twinkle	
砲	cannon/gun	
噴	erupt/spout/emit/flush out	
誇	boast/be proud/pride/triumphantly	
祥	auspicious/happiness/good omen	
牲	animal sacrifice/offering	
秩	regularity/salary/order	
帝	sovereign/the emperor/god/creator	
宏	wide/large	
唆	tempt/seduce/instigate/promote	
阻	thwart/separate from/prevent/obstruct/deter/impede	
泰	peaceful/calm/peace/easy/Thailand	
賄	bribe/board/supply/finance	
撲	slap/strike/hit/beat/tell/speak	
堀	ditch/moat/canal	
菊	chrysanthemum	
絞	strangle/constrict/wring	
縁	affinity/relation/connection/edge/border/verge/brink	
唯	solely/only/merely/simply	
膨	swell/get fat/thick	
矢	dart/arrow	
耐	-proof/enduring	
塾	cram school/private school	
漏	leak/escape/time	
慶	jubilation/congratulate/rejoice/be happy	
猛	fierce/rave/rush/become furious/wildness/strength	
芳	perfume/balmy/flavorable/fragrant	
懲	penal/chastise/punish/discipline	
剣	sabre/sword/blade/clock hand	
彰	patent/clear	
棋	chess piece/Japanese chess/shogi	
丁	street/ward/town/counter for guns/ tools/ leaves or cakes of something/even number/4th calendar sig	
恒	constancy/always	
揚	hoist/fry in deep fat	
冒	risk/face/defy/dare/damage/assume (a name)	
之	of/this	
倫	ethics/companion	
陳	exhibit/state/relate/explain	
憶	recollection/think/remember	
潜	submerge/conceal/hide/lower (voice)/hush	
梨	pear tree	
仁	humanity/virtue/benevolence/charity/man/kernel	
克	overcome/kindly/skillfully	
岳	point/peak/mountain	
概	outline/condition/approximation/generally	
拘	arrest/seize/concerned/adhere to/despite	
墓	grave/tomb	
黙	silence/become silent/stop speaking/leave as is	
須	ought/by all means/necessarily	
偏	partial/side/left-side radical/inclining/biased	
雰	atmosphere/fog	
遇	interview/treat/entertain/receive/deal with	
諮	consult with	
狭	cramped/narrow/contract/tight	
卓	eminent/table/desk/high	
亀	tortoise/turtle	
糧	provisions/food/bread	
簿	register/record book	
炉	hearth/furnace/kiln/reactor	
牧	breed/care for/shepherd/feed/pasture	
殊	particularly/especially/exceptionally	
殖	augment/increase/multiply/raise	
艦	warship	
輩	comrade/fellow/people/companions	
穴	hole/aperture/slit/cave/den	
奇	strange/strangeness/curiosity	
慢	ridicule/laziness	
鶴	crane/stork	
謀	conspire/cheat/impose on/plan/devise/scheme/have in mind/deceive	
暖	warmth	
昌	prosperous/bright/clear	
拍	clap/beat (music)	
朗	melodious/clear/bright/serene/cheerful	
寛	tolerant/leniency/generosity/relax/feel at home/be at ease/broadminded	
覆	capsize/cover/shade/mantle/be ruined	
胞	placenta/sac/sheath	
泣	cry/weep/moan	
隔	isolate/alternate/distance/separate/gulf	
浄	clean/purify/cleanse/exorcise/Manchu Dynasty	
没	drown/sink/hide/fall into/disappear/die	
暇	spare time/rest/leisure/time/leave of absence	
肺	lungs	
貞	upright/chastity/constancy/righteousness	
靖	peaceful	
鑑	specimen/take warning from/learn from	
飼	domesticate/raise/keep/feed	
陰	shade/yin/negative/sex organs/secret/shadow	
銘	inscription/signature (of artisan)	
随	follow/though/notwithstanding/while/during/both/all/obey/submit to/comply/at the mercy of (the wave	
烈	ardent/violent/vehement/furious/severe/extreme	
尋	inquire/fathom/look for	
稿	draft/copy/manuscript/straw	
丹	rust-colored/red/red lead/pills	
啓	disclose/open/say	
也	to be (classical)	
丘	hill/knoll	
棟	ridgepole/ridge	
壌	lot/earth/soil	
漫	cartoon/involuntarily/in spite of oneself/corrupt	
玄	mysterious/occultness	
粘	sticky/glutinous/greasy/persevere	
悟	enlightenment/perceive/discern/realize/understand	
舗	shop/store	
妊	pregnancy	
熟	mellow/ripen/mature/acquire skill	
旭	rising sun/morning sun	
恩	grace/kindness/goodness/favor/mercy/blessing/benefit	
騰	inflation/advancing/going	
往	journey/chase away/let go/going/travel	
豆	beans/pea/midget	
遂	consummate/accomplish/attain/commit (suicide)	
狂	lunatic/insane/crazy/confuse	
岐	branch off/fork in road/scene/arena/theater	
陛	highness/steps (of throne)	
緯	horizontal/woof/left & right/latitude	
培	cultivate/foster	
衰	decline/wane/weaken	
艇	rowboat/small boat	
屈	yield/bend/flinch/submit	
径	diameter/path/method	
淡	thin/faint/pale/fleeting	
抽	pluck/pull/extract/excel	
披	expose/open	
廷	courts/imperial court/government office	
錦	brocade/fine dress/honors	
准	quasi-/semi-/associate	
暑	sultry/hot/summer heat	
磯	seashore/beach	
奨	exhort/urge/encourage	
浸	immersed/soak/dip/steep/moisten/wet/dunk	
剰	surplus/besides	
胆	gall bladder/courage/pluck/nerve	
繊	slender/fine/thin kimono	
駒	pony/horse/colt	
虚	void/emptiness/unpreparedness/crack/fissure/untruth	
霊	spirits/soul	
帳	notebook/account book/album	
悔	repent/regret	
諭	rebuke/admonish/charge/warn/persuade	
惨	wretched/disaster/cruelty/harsh	
虐	tyrannize/oppress	
翻	flip/turn over/wave/flutter/change (mind)	
墜	crash/fall (down)	
沼	marsh/lake/bog/swamp/pond	
据	set/lay a foundation/install/equip/squat down/sit down	
肥	fertilizer/get fat/fertile/manure/pamper	
徐	gradually/slowly/deliberately/gently	
糖	sugar	
搭	board/load (a vehicle)/ride	
盾	shield/escutcheon/pretext	
脈	vein/pulse/hope	
滝	waterfall/rapids/cascade	
軌	rut/wheel/track/model/way of doing	
俵	bag/bale/sack/counter for bags	
妨	disturb/prevent/hamper/obstruct	
擦	grate/rub/scratch/scrape/chafe/scour	
鯨	whale	
荘	villa/inn/cottage/feudal manor	
諾	consent/assent/agreement	
雷	thunder/lightening bolt	
漂	drift/float (on liquid)	
懐	pocket/feelings/heart/yearn/miss someone/become attached to/bosom/breast	
勘	intuition/perception	
栽	plantation/planting	
拐	kidnap/falsify	
駄	burdensome/pack horse/horse load/send by horse	
添	annexed/accompany/marry/suit/meet/satisfy/attach/append/garnish/imitate	
冠	crown/best/peerless	
斜	diagonal/slanting/oblique	
鏡	mirror/speculum/barrel-head/round rice-cake offering	
聡	wise/fast learner	
浪	wandering/waves/billows	
亜	Asia/rank next/come after/-ous	
覧	perusal/see	
詐	lie/falsehood/deceive/pretend	
壇	podium/stage/rostrum/terrace	
勲	meritorious deed/merit	
魔	witch/demon/evil spirit	
酬	repay/reward/retribution	
紫	purple/violet	
曙	dawn/daybreak	
紋	family crest/figures	
卸	wholesale	
奮	stirred up/be invigorated/flourish	
欄	column/handrail/blank/space	
逸	deviate/idleness/leisure/miss the mark/evade/elude/parry/diverge	
涯	horizon/shore	
拓	clear (the land)/open/break up (land)	
眼	eyeball	
獄	prison/jail	
尚	esteem/furthermore/still/yet	
彫	carve/engrave/chisel	
穏	calm/quiet/moderation	
顕	appear/existing	
巧	adroit/skilled/ingenuity	
矛	halberd/arms/festival float	
垣	hedge/fence/wall	
欺	deceit/cheat/delude	
釣	angling/fish/catch/allure/ensnare	
萩	bush clover	
粛	solemn/quietly/softly	
栗	chestnut	
愚	foolish/folly/absurdity/stupid	
嘉	applaud/praise/esteem	
遭	encounter/meet/party/association/interview/join	
架	erect/frame/mount/support/shelf/construct	
鬼	ghost/devil	
庶	commoner/all/bastard	
稚	immature/young	
滋	nourishing/more & more/be luxuriant/planting/turbidity	
幻	phantasm/vision/dream/illusion/apparition	
煮	boil/cook	
姫	princess	
誓	vow/swear/pledge	
把	grasp/faggot/bunch/counter for bundles	
践	tread/step on/trample/practice/carry through	
呈	display/offer/present/send/exhibit	
疎	alienate/rough/neglect/shun/sparse	
仰	face-up/look up/depend/seek/respect/rever/drink/take	
剛	sturdy/strength	
疾	rapidly	
征	subjugate/attack the rebellious/collect taxes	
砕	smash/break/crush/familiar/popular	
謡	noh chanting	
嫁	marry into/bride	
謙	self-effacing/humble oneself/condescend/be modest	
后	empress/queen/after/behind/back/later	
嘆	sigh/lament/moan/grieve	
菌	germ/fungus/bacteria	
鎌	sickle/scythe/trick	
巣	nest/rookery/hive/cobweb/den	
頻	repeatedly/recur	
琴	harp/koto	
班	squad/corps/unit/group	
棚	shelf/ledge/rack/mount/mantle/trellis	
潔	undefiled/pure/clean/righteous/gallant	
酷	cruel/severe/atrocious/unjust	
宰	superintend/manager/rule	
廊	corridor/hall/tower	
寂	loneliness/quietly/mellow/mature/death of a priest	
辰	sign of the dragon/7-9AM/fifth sign of Chinese zodiac	
霞	be hazy/grow dim/blurred	
伏	prostrated/bend down/bow/cover/lay (pipes)	
碁	Go	
俗	vulgar/customs/manners/worldliness/mundane things	
漠	vague/obscure/desert/wide	
邪	wicked/injustice/wrong	
晶	sparkle/clear/crystal	
墨	black ink/India ink/ink stick/Mexico	
鎮	tranquilize/ancient peace-preservation centers	
洞	den/cave/excavation	
履	footgear/shoes/boots/put on (the feet	
劣	inferiority/be inferior to/be worse	
那	what?	
殴	assault/hit/beat/thrash	
娠	with child/pregnancy	
奉	observance/offer/present/dedicate	
憂	melancholy/grieve/lament/be anxious/sad/unhappy	
朴	crude/simple/plain/docile	
亭	pavilion/restaurant/mansion/arbor/cottage/vaudeville/music hall/stage name	
淳	pure	
怪	suspicious/mystery/apparition	
鳩	pigeon/dove	
酔	drunk/feel sick/poisoned/elated/spellbound	
惜	pity/be sparing of/frugal/stingy/regret	
穫	harvest/reap	
佳	excellent/beautiful/good/pleasing/skilled	
潤	wet/be watered/profit by/receive benefits/favor/charm/steep	
悼	lament/grieve over	
乏	destitution/scarce/limited	
該	above-stated/the said/that specific	
赴	proceed/get/become/tend	
桑	mulberry	
桂	Japanese Judas-tree/cinnamon tree	
髄	marrow/pith	
虎	tiger/drunkard	
盆	basin/lantern festival/tray	
晋	advance	
穂	ear/ear (grain)/head/crest (wave)	
壮	robust/manhood/prosperity	
堤	dike/bank/embankment	
飢	hungry/starve	
傍	bystander/side/besides/while/nearby/3rd person	
疫	epidemic	
累	accumulate/involvement/trouble/tie up/continually	
痴	stupid/foolish	
搬	conveyor/carry/transport	
晃	clear	
癒	healing/cure/quench (thirst)/wreak	
桐	paulownia	
寸	measurement/foot/10	
郭	enclosure/quarters/fortification/red-light district	
尿	urine	
凶	villain/evil/bad luck/disaster	
吐	spit/vomit/belch/confess/tell (lies)	
宴	banquet/feast/party	
鷹	hawk	
賓	V.I.P./guest	
虜	captive/barbarian/low epithet for the enemy	
陶	pottery/porcelain	
鐘	bell/gong/chimes	
憾	remorse/regret/be sorry	
猪	boar	
紘	large	
磁	magnet/porcelain	
弥	all the more/increasingly	
昆	descendants/elder brother/insect	
粗	coarse/rough/rugged	
訂	revise/correct/decide	
芽	bud/sprout/spear/germ	
庄	level	
傘	umbrella	
敦	industry/kindliness	
騎	equestrian/riding on horses/counter for equestrians	
寧	rather/preferably	
循	sequential/fellow	
忍	endure/bear/put up with/conceal/secrete/spy/sneak	
怠	neglect/laziness	
如	likeness/like/such as/as if/better/best/equal	
寮	dormitory/hostel/villa/tea pavillion	
祐	help	
鵬	phoenix	
鉛	lead	
珠	pearl/gem/jewel	
凝	congeal/freeze/stiff/be absorbed in	
苗	seedling/sapling/shoot	
獣	animal/beast	
哀	pathetic/grief/sorrow/pathos/pity/sympathize	
跳	hop/leap up/spring/jerk/prance/buck/splash/sputter/snap	
匠	artisan/workman/carpenter	
垂	droop/suspend/hang/slouch	
蛇	snake/serpent/hard drinker	
澄	lucidity/be clear/clear/clarify/settle/strain/look grave	
縫	sew/stitch/embroider	
僧	Buddhist priest/monk	
眺	stare/watch/look at/see/scrutinize	
亘	span/request	
呉	give/do something for	
凡	mediocre	
憩	recess/rest/relax/repose	
媛	beautiful woman/princess	
溝	gutter/ditch/sewer/drain/10**32	
恭	respect/reverent	
刈	reap/cut/clip/trim/prune	
睡	drowsy/sleep/die	
錯	confused/mix/be in disorder	
伯	chief/count/earl/uncle/Brazil	
笹	bamboo grass	
穀	cereals/grain	
陵	mausoleum/imperial tomb	
霧	fog/mist	
魂	soul/spirit	
弊	abuse/evil/vice/breakage	
妃	queen/princess	
舶	liner/ship	
餓	starve/hungry/thirst	
窮	hard up/destitute/suffer/perplexed/cornered	
掌	manipulate/rule/administer/conduct/palm of hand	
麗	lovely/companion	
綾	design/figured cloth/twill	
臭	stinking/ill-smelling/suspicious looking/odor/savor/fragrance/be fragrant/stink/glow/be bright	
悦	ecstasy/joy/rapture	
刃	blade/sword/edge	
縛	truss/arrest/bind/tie/restrain	
暦	calendar/almanac	
宜	best regards/good	
盲	blind/blind man/ignoramus	
粋	chic/style/purity/essence/pith/cream/elite/choice	
辱	embarrass/humiliate/shame	
毅	strong	
轄	control/wedge	
猿	monkey	
弦	bowstring/chord/hypotenuse	
稔	harvest/ripen	
窒	plug up/obstruct	
炊	cook/boil	
洪	deluge/flood/vast	
摂	vicarious/surrogate/act in addition to	
飽	sated/tired of/bored/satiate	
冗	superfluous/uselessness	
桃	peach tree	
狩	hunt/raid/gather	
朱	vermilion/cinnabar/scarlet/red/bloody	
渦	whirlpool/eddy/vortex	
紳	sire/good belt/gentleman	
枢	hinge/pivot/door	
碑	tombstone/monument	
鍛	forge/discipline/train	
刀	sword/saber/knife	
鼓	drum/beat/rouse/muster	
裸	naked/nude/uncovered/partially clothed	
猶	furthermore/still/yet	
塊	clod/lump/chink/clot/mass	
旋	rotation/go around	
弓	bow/bow (archery/ violin)	
幣	cash/bad habit/humble prefix/gift/Shinto offerings of cloth/rope/cut paper	
膜	membrane	
扇	fan/folding fan	
腸	intestines/guts/bowels/viscera	
槽	vat/tub/tank	
慈	mercy	
楊	willow	
伐	fell/strike/attack/punish	
駿	a good horse/speed/a fast person	
漬	pickling/soak/moisten/steep	
糾	twist/ask/investigate/verify	
亮	clear/help	
墳	tomb/mound	
坪	two-mat area/~36 sq ft	
紺	dark blue/navy	
娯	recreation/pleasure	
椿	camellia	
舌	tongue/reed/clapper	
羅	gauze/thin silk/Rome	
峡	gorge/ravine	
俸	stipend/salary	
厘	rin/1/10sen/1/10bu	
峰	summit/peak	
圭	square jewel/corner/angle/edge	
醸	brew/cause	
蓮	lotus	
弔	condolences/mourning/funeral	
乙	the latter/duplicate/strange/witty	
汁	soup/juice/broth/sap/gravy/pus	
尼	nun	
遍	everywhere/times/widely/generally	
衡	equilibrium/measuring rod/scale	
薫	send forth fragrance/fragrant/be scented/smoke (tobacco)	
猟	game-hunting/shooting/game/bag	
羊	sheep	
款	goodwill/article/section/friendship/collusion	
閲	review/inspection/revision	
偵	spy	
喝	hoarse/scold	
敢	daring/sad/tragic/pitiful/frail/feeble	
胎	womb/uterus	
酵	fermentation	
憤	aroused/resent/be indignant/anger	
豚	pork/pig	
遮	intercept/interrupt/obstruct	
扉	front door/title page/front page	
硫	sulphur	
赦	pardon/forgiveness	
窃	stealth/steal/secret/private/hushed	
泡	bubbles/foam/suds/froth	
瑞	congratulations	
又	or again/furthermore/on the other hand	
慨	rue/be sad/sigh/lament	
紡	spinning	
恨	regret/bear a grudge/resentment/malice/hatred	
肪	obese/fat	
扶	aid/help/assist	
戯	frolic/play/sport	
伍	5/5-man squad/file/line	
忌	mourning/abhor/detestable/death anniversary	
濁	voiced/uncleanness/wrong/nigori/impurity	
奔	bustle/run	
斗	Big Dipper/10 sho (vol)/sake dipper	
蘭	orchid/Holland	
迅	swift/fast	
肖	resemblance	
鉢	bowl/rice tub/pot/crown	
朽	decay/rot/remain in seclusion	
殻	husk/nut shell	
享	receive/undergo/answer (phone)/take/get/catch	
秦	Manchu dynasty/name given to naturalized foreigners	
茅	miscanthus reed	
藩	clan/enclosure	
沙	sand	
輔	help	
媒	mediator/go-between	
鶏	chicken	
禅	Zen/silent meditation	
嘱	entrust/request/send a message	
胴	trunk/torso/hull (ship)/hub of wheel	
迭	transfer/alternation	
挿	insert/put in/graft/wear (sword)	
嵐	storm/tempest	
椎	oak/mallet	
絹	silk	
陪	obeisance/follow/accompany/attend on	
剖	divide	
譜	musical score/music/note/staff/table/genealogy	
郁	cultural progress/perfume	
悠	permanence/distant/long time/leisure	
淑	graceful/gentle/pure	
帆	sail	
暁	daybreak/dawn/in the event	
傑	greatness/excellence	
楠	camphor tree	
笛	flute/clarinet/pipe/whistle/bagpipe/piccolo	
玲	sound of jewels	
奴	guy/slave/manservant/fellow	
錠	lock/fetters/shackles	
拳	fist	
翔	soar/fly	
遷	transition/move/change	
拙	bungling/clumsy/unskillful	
侍	waiter/samurai/wait upon/serve	
尺	shaku/Japanese foot/measure/scale/rule	
峠	mountain peak/mountain pass/climax/crest/(kokuji)	
篤	fervent/kind/cordial/serious/deliberate	
肇	beginning	
渇	thirst/dry up/parch	
叔	uncle/youth	
雌	feminine/female	
亨	undergo/answer (phone)/take/get/catch	
堪	withstand/endure/support/resist	
叙	confer/relate/narrate/describe	
酢	vinegar/sour/acid/tart	
吟	versify/singing/recital	
逓	relay/in turn/sending	
嶺	peak/summit	
甚	tremendously/very/great/exceedingly	
喬	high/boasting	
崇	adore/respect/revere/worship	
漆	lacquer/varnish/seven	
岬	headland/cape/spit/promontory	
癖	mannerism/habit/vice/trait/fault/kink	
愉	pleasure/happy/rejoice	
寅	sign of the tiger/3-5AM/third sign of Chinese zodiac	
礁	reef/sunken rock	
乃	from/possessive particle/whereupon/accordingly	
洲	continent/sandbar/island/country	
屯	barracks/police station/camp	
樺	birch	
槙	twig/ornamental evergreen	
姻	matrimony/marry	
巌	rock/crag/boulder	
擬	mimic/aim (a gun) at/nominate/imitate	
塀	fence/wall/(kokuji)	
唇	lips	
睦	intimate/friendly/harmonious	
閑	leisure	
胡	barbarian/foreign	
幽	seclude/confine to a room	
峻	high/steep	
曹	cadet/friend	
詠	recitation/poem/song/composing	
卑	lowly/base/vile/vulgar	
侮	scorn/despise/make light of/contempt	
鋳	casting/mint	
抹	rub/paint/erase	
尉	military officer/jailer/old man/rank	
槻	Zelkova tree	
隷	slave/servant/prisoner/criminal/follower	
禍	calamity/misfortune/evil/curse	
蝶	butterfly	
酪	dairy products/whey/broth/fruit juice	
茎	stalk/stem	
帥	commander/leading troops/governor	
逝	departed/die	
汽	vapor/steam	
琢	polish	
匿	hide/shelter/shield	
襟	collar/neck/lapel	
蛍	lightning-bug/firefly	
蕉	banana	
寡	widow/minority/few	
琉	lapis lazuli	
痢	diarrhea	
庸	commonplace/ordinary/employment	
朋	companion/friend	
坑	pit/hole	
藍	indigo	
賊	burglar/rebel/traitor/robber	
搾	squeeze	
畔	paddy ridge/levee	
遼	distant	
唄	songs with samisen	
孔	cavity/hole/slit/very/great/exceedingly	
橘	mandarin orange	
漱	gargle/rinse mouth	
呂	spine/backbone	
拷	torture/beat	
嬢	lass/girl/Miss/daughter	
苑	garden/farm/park	
巽	southeast	
杜	woods/grove	
渓	mountain stream/valley	
翁	venerable old man	
廉	bargain/reason/charge/suspicion/point/account/purity/honest/low price/cheap/rested/contented/peacef	
謹	discreet/reverently/humbly	
瞳	pupil	
湧	boil/ferment/seethe/uproar/breed	
欣	take pleasure in/rejoice	
窯	kiln/oven/furnace	
褒	praise/extol	
醜	ugly/unclean/shame/bad looking	
升	measuring box/1.8 liter	
殉	martyrdom/follow by resigning	
煩	anxiety/trouble/worry/pain/ill/annoy/nuisance/irksome	
巴	comma-design	
禎	happiness	
劾	censure/criminal investigation	
堕	degenerate/descend to/lapse into	
租	tariff/crop tax/borrowing	
稜	angle/edge/corner/power/majesty	
桟	scaffold/cleat/frame/jetty/bolt (door)	
倭	Yamato/ancient Japan	
婿	bridegroom/son-in-law	
慕	pining/yearn for/love dearly/adore	
斐	beautiful/patterned	
罷	quit/stop/leave/withdraw/go	
矯	rectify/straighten/correct/reform/cure/control/pretend/falsify	
某	so-and-so/one/a certain/that person	
囚	captured/criminal/arrest/catch	
魁	charging ahead of others	
虹	rainbow	
鴻	large bird/wild goose	
泌	ooze/flow/soak in/penetrate/secrete	
於	at/in/on/as for	
赳	strong and brave	
漸	steadily/gradually advancing/finally/barely	
蚊	mosquito	
葵	hollyhock	
厄	unlucky/misfortune/bad luck/disaster	
藻	seaweed/duckweed	
禄	fief/allowance/pension/grant/happiness	
孟	chief/beginning	
嫡	legitimate wife/direct descent (non-bastard)	
尭	high/far	
嚇	menacing/dignity/majesty/threaten	
巳	sign of the snake or serpent/9-11AM/sixth sign of Chinese zodiac	
凸	convex/beetle brow/uneven	
暢	stretch	
韻	rhyme/elegance/tone	
霜	frost	
硝	nitrate/saltpeter	
勅	imperial order	
芹	parsley	
杏	apricot	
棺	coffin/casket	
儒	Confucian	
鳳	male mythical bird	
馨	fragrant/balmy/favourable	
慧	wise	
愁	distress/grieve/lament/be anxious	
楼	watchtower/lookout/high building	
彬	refined/gentle	
匡	correct/save/assist	
眉	eyebrow	
欽	respect/revere/long for	
薪	fuel/firewood/kindling	
褐	brown/woollen kimono	
賜	grant/gift/boon/results	
嵯	steep/craggy/rugged	
綜	rule	
繕	darning/repair/mend/trim/tidy up/adjust	
栓	plug/bolt/cork/bung/stopper	
翠	green	
鮎	freshwater trout/smelt	
榛	hazelnut/filbert	
凹	concave/hollow/sunken	
艶	glossy/luster/glaze/polish/charm/colorful/captivating	
惣	all	
蔦	vine/ivy	
錬	tempering/refine/drill/train/polish	
隼	falcon	
渚	strand/beach/shore	
衷	inmost/heart/mind/inside	
逐	pursue/drive away/chase/accomplish/attain/commit	
斥	reject/retreat/recede/withdraw/repel/repulse	
稀	rare/phenomenal/dilute (acid)	
芙	lotus/Mt Fuji	
詔	imperial edict	
皐	swamp/shore	
雛	chick/squab/duckling/doll	
惟	consider/reflect/think	
佑	help/assist	
耀	shine/sparkle/gleam/twinkle	
黛	blackened eyebrows	
渥	kindness	
憧	yearn after/long for/aspire to/admire/adore	
宵	wee hours/evening/early night	
妄	delusion/unnecessarily/without authority/reckless	
惇	sincere/kind/considerate	
脩	dried meat	
甫	for the first time/not until	
酌	bar-tending/serving sake/the host/draw (water)/ladle/scoop/pump	
蚕	silkworm	
嬉	glad/pleased/rejoice	
蒼	blue/pale	
暉	shine/light	
頒	distribute/disseminate/partition/understand	
只	only/free/in addition	
肢	limb/arms & legs	
檀	cedar/sandlewood/spindle tree	
凱	victory song	
彗	comet	
謄	mimeograph/copy	
梓	catalpa tree	
丑	sign of the ox or cow/1-3AM/second sign of Chinese zodiac	
嗣	heir/succeed	
叶	grant/answer	
汐	eventide/tide/salt water/opportunity	
絢	kimono design	
朔	conjunction (astronomy)/first day of month	
伽	nursing/attending/entertainer	
畝	furrow/30 tsubo/ridge/rib	
抄	extract/selection/summary/copy/spread thin	
爽	refreshing/bracing/resonant/sweet/clear	
黎	dark/black/many	
惰	lazy/laziness	
蛮	barbarian	
冴	be clear/serene/cold/skilful	
萌	show symptoms of/sprout/bud/malt	
旺	flourishing/successful/beautiful/vigorous	
壱	I/one	
偲	recollect/remember	
瑠	lapis lazuli	
允	license/sincerity/permit	
侯	marquis/lord/daimyo	
蒔	sow (seeds)	
鯉	carp	
弧	arc/arch/bow	
遥	far off/distant/long ago	
舜	type of morning glory/rose of Sharon/althea	
瑛	sparkle of jewelry/crystal	
附	affixed/attach/refer to/append	
彪	spotted/mottled/patterned/small tiger	
卯	sign of the hare or rabbit/5-7AM/fourth sign of Chinese zodiac/east	
但	however/but	
綺	figured cloth/beautiful	
芋	potato	
茜	madder/red dye/Turkey red	
凌	endure/keep (rain)out/stave off/tide over/defy/slight/surpass	
皓	white/clear	
洸	sparkling water	
毬	burr/ball	
婆	old woman/grandma/wet nurse	
緋	scarlet/cardinal	
鯛	sea bream/red snapper	
怜	wise	
邑	village/rural community/right village radical (no. 163)	
倣	emulate/imitate	
碧	blue/green	
啄	peck/pick up	
穣	good crops/prosperity/10**28	
酉	west/bird/sign of the bird/5-7PM/tenth sign of Chinese zodiac/sake radical (no. 164)	
悌	serving our elders	
倹	frugal/economy/thrifty	
柚	citron	
繭	cocoon	
亦	also/again	
詢	consult with	
采	dice/form/appearance/take/coloring	
紗	gauze/gossamer	
賦	levy/ode/prose/poem/tribute/installment	
眸	pupil of the eye	
玖	beautiful black jewel/nine	
弐	II/two/second	
錘	weight/plumb bob/sinker	
諄	tedious	
倖	happiness/luck	
痘	pox/smallpox	
笙	a reed instrument	
侃	strong/just/righteous/peace-loving	
裟	Buddhist surplice	
洵	alike/truth	
爾	you/thou/second person	
耗	decrease	
昴	the Pleiades	
銑	pig iron	
莞	reed used to cover tatami	
伶	actor	
碩	large/great/eminent	
宥	soothe/calm/pacify	
滉	deep and broad	
晏	late/quiet/sets (sun)	
伎	deed/skill	
朕	majestic plural/imperial we	
迪	edify/way/path	
綸	thread/silk cloth	
且	moreover/also/furthermore	
竣	end/finish	
晨	morning/early	
吏	officer/an official	
燦	brilliant	
麿	I/you/(kokuji)	
頌	eulogy	
箇	counters for things	
楓	maple	
琳	jewel/tinkling of jewelry	
梧	Chinese parasol tree/phoenix tree	
哉	how/what/alas/ (question mark)	
澪	water route/shipping channel	
匁	monme/3.75 grams/(kokuji)	
晟	clear	
衿	neck/collar/lapel	
凪	lull/calm/(kokuji)	
梢	treetops/twig	
丙	third class/3rd/3rd calendar sign	
颯	suddenly/smoothly	
茄	eggplant	
勺	ladle/one tenth of a go/dip	
恕	excuse/tolerate/forgive	
蕗	butterbur/bog rhubarb	
瑚	ancestral offering receptacle	
遵	abide by/follow/obey/learn	
瞭	clear	
燎	burn/bonfire	
虞	uneasiness/fear/anxiety/concern	
柊	holly	
侑	urge to eat	
謁	audience/audience (with king)	
斤	axe/1.32 lb/catty/counter for loaves of bread	
嵩	be aggravated/grow worse/grow bulky/swell	
捺	press/print/affix a seal/stamp	
蓉	lotus	
茉	jasmine	
袈	a coarse camlet	
燿	shine	
誼	friendship/intimacy	
冶	melting/smelting	
栞	bookmark/guidebook	
墾	ground-breaking/open up farmland	
勁	strong	
菖	iris	
旦	nightbreak/dawn/morning	
椋	type of deciduous tree/grey starling	
叡	intelligence/imperial	
紬	pongee (a knotted silk cloth)	
胤	descendent/issue/offspring	
凜	cold/strict/severe	
亥	sign of the hog/9-11PM/twelfth sign of the Chinese zodiac	
爵	baron/peerage/court rank	
脹	dilate/distend/bulge/fill out/swell	
麟	Chinese unicorn/genius/giraffe/bright/shining	
莉	jasmine	
汰	luxury/select	
瑶	beautiful as a jewel	
瑳	polish	
耶	question mark	
椰	coconut tree	
絃	string/cord/samisen music	
丞	help	
璃	glassy/lapis lazuli	
奎	star/god of literature	
塑	model/molding	
昂	rise	
柾	straight grain/spindle tree/(kokuji)	
熙	bright/sunny/prosperous/merry	
菫	the violet	
諒	fact/reality/understand/appreciate	
鞠	ball	
崚	towering in a row	
濫	excessive/overflow/spread out	
捷	victory/fast	