遭う	あう	
扇ぐ	あおぐ	
青白い	あおじろい	
明き	あき	
飽くまで	あくまで	
明け方	あけがた	
揚げる	あげる	
挙げる	あげる	
憧れる	あこがれる	
足跡	あしあと	
味わう	あじわう	
預かる	あずかる	
暖まる	あたたまる	
暖める	あたためる	
あひら	あひら	
厚かましい	あつかましい	
圧縮	あっしゅく	
宛名	あてな	
暴れる	あばれる	
脂	あぶら	
雨戸	あまど	
甘やかす	あまやかす	
余る	あまる	
編物	あみもの	
編む	あむ	
危うい	あやうい	
怪しい	あやしい	
荒い	あらい	
粗い	あらい	
争う	あらそう	
改めて	あらためて	
改める	あらためる	
著す	あらわす	
有難い	ありがたい	
在る	ある	
安易	あんい	
案外	あんがい	
言い出す	いいだす	
言い付ける	いいつける	
意義	いぎ	
生き生き	いきいき	
育児	いくじ	
幾分	いくぶん	
生け花	いけばな	
以後	いご	
以降	いこう	
勇ましい	いさましい	
衣食住	いしょくじゅう	
意地悪	いじわる	
一応	いちおう	
一段と	いちだんと	
一流	いちりゅう	
佚	いつ	
一昨日	いっさくじつ	
一昨年	いっさくねん	
一斉	いっせい	
一旦	いったん	
一定	いってい	
移転	いてん	
井戸	いど	
緯度	いど	
従姉妹	いとこ	
威張る	いばる	
嫌がる	いやがる	
煎る	いる	
炒る	いる	
入れ物	いれもの	
引力	いんりょく	
植木	うえき	
飢える	うえる	
浮ぶ	うかぶ	
浮かべる	うかべる	
浮く	うく	
承る	うけたまわる	
受取	うけとり	
受け持つ	うけもつ	
薄暗い	うすぐらい	
薄める	うすめる	
打合せ	うちあわせ	
打ち消す	うちけす	
討つ	うつ	
映す	うつす	
写る	うつる	
映る	うつる	
有無	うむ	
埋める	うめる	
敬う	うやまう	
裏返す	うらがえす	
裏口	うらぐち	
占う	うらなう	
恨み	うらみ	
恨む	うらむ	
羨ましい	うらやましい	
羨む	うらやむ	
売上	うりあげ	
売り切れ	うりきれ	
売り切れる	うりきれる	
売行き	うれゆき	
運河	うんが	
英文	えいぶん	
英和	えいわ	
液体	えきたい	
絵の具	えのぐ	
偉い	えらい	
宴会	えんかい	
園芸	えんげい	
演劇	えんげき	
円周	えんしゅう	
遠足	えんそく	
延長	えんちょう	
煙突	えんとつ	
追い掛ける	おいかける	
追い越す	おいこす	
応援	おうえん	
王女	おうじょ	
応ずる	おうずる	
応接	おうせつ	
応対	おうたい	
往復	おうふく	
欧米	おうべい	
応用	おうよう	
大通り	おおどおり	
大凡	おおよそ	
お帰り	おかえり	
拝む	おがむ	
お代わり	おかわり	
補う	おぎなう	
屋外	おくがい	
送り仮名	おくりがな	
怠る	おこたる	
押える	おさえる	
納める	おさめる	
治める	おさめる	
惜しい	おしい	
御辞儀	おじぎ	
伯父さん	おじさん	
小父さん	おじさん	
叔父さん	おじさん	
教わる	おそわる	
落着く	おちつく	
御手洗	おてあらい	
お出掛け	おでかけ	
お手伝いさん	おてつだいさん	
落し物	おとしもの	
驚かす	おどろかす	
各々	おのおの	
伯母さん	おばさん	
叔母さん	おばさん	
お参り	おまいり	
思い掛けない	おもいがけない	
思い込む	おもいこむ	
思いっ切り	おもいっきり	
思い付く	おもいつく	
重たい	おもたい	
親指	おやゆび	
卸す	おろす	
恩恵	おんけい	
温室	おんしつ	
温泉	おんせん	
温帯	おんたい	
御中	おんちゅう	
女の人	おんなのひと	
蚊	か	
貝	かい	
開会	かいかい	
会館	かいかん	
改札	かいさつ	
解散	かいさん	
海水浴	かいすいよく	
回数	かいすう	
回数券	かいすうけん	
改正	かいせい	
快晴	かいせい	
解説	かいせつ	
改造	かいぞう	
開通	かいつう	
回転	かいてん	
解答	かいとう	
回答	かいとう	
外部	がいぶ	
解放	かいほう	
開放	かいほう	
海洋	かいよう	
概論	がいろん	
帰す	かえす	
却って	かえって	
代える	かえる	
反る	かえる	
家屋	かおく	
係わる	かかわる	
書留	かきとめ	
書取	かきとり	
垣根	かきね	
掻く	かく	
嗅ぐ	かぐ	
架空	かくう	
各自	かくじ	
拡充	かくじゅう	
学術	がくじゅつ	
各地	かくち	
拡張	かくちょう	
角度	かくど	
学年	がくねん	
学部	がくぶ	
格別	かくべつ	
確率	かくりつ	
学力	がくりょく	
掛け算	かけざん	
可決	かけつ	
火口	かこう	
下降	かこう	
重なる	かさなる	
重ねる	かさねる	
飾り	かざり	
火山	かざん	
貸し出し	かしだし	
過失	かしつ	
果実	かじつ	
貸間	かしま	
貸家	かしや	
個所	かしょ	
過剰	かじょう	
課税	かぜい	
下線	かせん	
加速	かそく	
加速度	かそくど	
固い	かたい	
堅い	かたい	
片仮名	かたかな	
片付く	かたづく	
塊	かたまり	
固まる	かたまる	
片道	かたみち	
傾く	かたむく	
片寄る	かたよる	
学科	がっか	
学会	がっかい	
楽器	がっき	
学級	がっきゅう	
担ぐ	かつぐ	
括弧	かっこ	
活字	かつじ	
活躍	かつやく	
活力	かつりょく	
仮定	かてい	
過程	かてい	
課程	かてい	
仮名	かな	
仮名遣い	かなづかい	
鐘	かね	
加熱	かねつ	
兼ねる	かねる	
過半数	かはんすう	
被せる	かぶせる	
釜	かま	
紙屑	かみくず	
神様	かみさま	
剃刀	かみそり	
貨物	かもつ	
歌謡	かよう	
殻	から	
空っぽ	からっぽ	
枯れる	かれる	
乾かす	かわかす	
渇く	かわく	
為替	かわせ	
瓦	かわら	
代る	かわる	
間隔	かんかく	
換気	かんき	
感激	かんげき	
関西	かんさい	
鑑賞	かんしょう	
感ずる	かんずる	
間接	かんせつ	
乾燥	かんそう	
感想	かんそう	
観測	かんそく	
寒帯	かんたい	
官庁	かんちょう	
勘違い	かんちがい	
缶詰	かんづめ	
乾電池	かんでんち	
関東	かんとう	
観念	かんねん	
乾杯	かんぱい	
看板	かんばん	
看病	かんびょう	
冠	かんむり	
漢和	かんわ	
気圧	きあつ	
器械	きかい	
着替え	きがえ	
機関車	きかんしゃ	
飢饉	ききん	
器具	きぐ	
期限	きげん	
記号	きごう	
刻む	きざむ	
儀式	ぎしき	
基準	きじゅん	
規準	きじゅん	
起床	きしょう	
着せる	きせる	
基礎	きそ	
気体	きたい	
基地	きち	
基盤	きばん	
客席	きゃくせき	
客間	きゃくま	
休業	きゅうぎょう	
休講	きゅうこう	
休息	きゅうそく	
給与	きゅうよ	
休養	きゅうよう	
清い	きよい	
強化	きょうか	
境界	きょうかい	
行事	ぎょうじ	
恐縮	きょうしゅく	
教養	きょうよう	
行列	ぎょうれつ	
漁業	ぎょぎょう	
曲線	きょくせん	
規律	きりつ	
斬る	きる	
気を付ける	きをつける	
金魚	きんぎょ	
区域	くいき	
偶数	ぐうすう	
空想	くうそう	
空中	くうちゅう	
釘	くぎ	
区切る	くぎる	
櫛	くし	
苦情	くじょう	
苦心	くしん	
屑	くず	
崩す	くずす	
薬指	くすりゆび	
崩れる	くずれる	
砕く	くだく	
砕ける	くだける	
下る	くだる	
唇	くちびる	
口紅	くちべに	
句読点	くとうてん	
配る	くばる	
工夫	くふう	
区分	くぶん	
組合せ	くみあわせ	
組み立てる	くみたてる	
汲む	くむ	
悔しい	くやしい	
酌む	くむ	
悔やむ	くやむ	
咥える	くわえる	
稽古	けいこ	
郡	ぐん	
敬語	けいご	
蛍光灯	けいこうとう	
形式	けいしき	
継続	けいぞく	
毛糸	けいと	
系統	けいとう	
経度	けいど	
芸能	げいのう	
競馬	けいば	
警備	けいび	
形容詞	けいようし	
形容動詞	けいようどうし	
外科	げか	
毛皮	けがわ	
激増	げきぞう	
下車	げしゃ	
下旬	げじゅん	
下水	げすい	
削る	けずる	
桁	けた	
下駄	げた	
血圧	けつあつ	
血液	けつえき	
月給	げっきゅう	
傑作	けっさく	
月末	げつまつ	
気配	けはい	
下品	げひん	
煙い	けむい	
蹴る	ける	
けれど/けれども		
険しい	けわしい	
見学	けんがく	
謙虚	けんきょ	
原稿	げんこう	
原産	げんさん	
原始	げんし	
研修	けんしゅう	
厳重	げんじゅう	
謙遜	けんそん	
県庁	けんちょう	
限度	げんど	
現に	げんに	
顕微鏡	けんびきょう	
原理	げんり	
原料	げんりょう	
碁	ご	
恋しい	こいしい	
請う	こう	
工員	こういん	
強引	ごういん	
公害	こうがい	
高級	こうきゅう	
公共	こうきょう	
工芸	こうげい	
孝行	こうこう	
交差	こうさ	
講師	こうし	
工事	こうじ	
公式	こうしき	
口実	こうじつ	
こうして	こうして	
校舎	こうしゃ	
公衆	こうしゅう	
香水	こうすい	
公正	こうせい	
功績	こうせき	
光線	こうせん	
高層	こうそう	
構造	こうぞう	
交替	こうたい	
耕地	こうち	
交通機関	こうつうきかん	
校庭	こうてい	
肯定	こうてい	
高度	こうど	
高等	こうとう	
合同	ごうどう	
後輩	こうはい	
公表	こうひょう	
鉱物	こうぶつ	
公務	こうむ	
項目	こうもく	
紅葉	こうよう	
合理	ごうり	
交流	こうりゅう	
合流	ごうりゅう	
効力	こうりょく	
超える	こえる	
焦がす	こがす	
国王	こくおう	
国籍	こくせき	
国立	こくりつ	
焦げる	こげる	
凍える	こごえる	
心当たり	こころあたり	
心得る	こころえる	
腰掛け	こしかけ	
腰掛ける	こしかける	
五十音	ごじゅうおん	
胡椒	こしょう	
超す	こす	
擦る	こする	
個体	こたい	
御馳走	ごちそう	
小遣い	こづかい	
古典	こてん	
琴	こと	
言付ける	ことづける	
言葉遣い	ことばづかい	
御無沙汰	ごぶさた	
塵芥	ごみ	
御免	ごめん	
小指	こゆび	
娯楽	ごらく	
御覧	ごらん	
転がす	ころがす	
転がる	ころがる	
紺	こん	
混合	こんごう	
献立	こんだて	
在学	ざいがく	
再三	さいさん	
祭日	さいじつ	
催促	さいそく	
採点	さいてん	
災難	さいなん	
裁縫	さいほう	
材木	ざいもく	
逆さ	さかさ	
逆様	さかさま	
捜す	さがす	
遡る	さかのぼる	
酒場	さかば	
先程	さきほど	
裂く	さく	
索引	さくいん	
作者	さくしゃ	
削除	さくじょ	
作成	さくせい	
作製	さくせい	
探る	さぐる	
囁く	ささやく	
刺さる	ささる	
匙	さじ	
座敷	ざしき	
差し支え	さしつかえ	
差し引き	さしひき	
刺身	さしみ	
刺す	さす	
挿す	さす	
注す	さす	
射す	さす	
流石	さすが	
撮影	さつえい	
雑音	ざつおん	
早速	さっそく	
錆	さび	
錆びる	さびる	
座布団	ざぶとん	
冷ます	さます	
妨げる	さまたげる	
冷める	さめる	
再来月	さらいげつ	
再来週	さらいしゅう	
再来年	さらいねん	
騒がしい	さわがしい	
三角	さんかく	
算数	さんすう	
酸性	さんせい	
産地	さんち	
山林	さんりん	
仕上がる	しあがる	
寺院	じいん		
自衛	じえい	
塩辛い	しおからい	
司会	しかい	
四角	しかく	
四角い	しかくい	
時間割	じかんわり	
四季	しき	
敷地	しきち	
至急	しきゅう	
敷く	しく	
茂る	しげる	
持参	じさん	
磁石	じしゃく	
四捨五入	ししゃごにゅう	
始終	しじゅう	
自習	じしゅう	
静まる	しずまる	
姿勢	しせい	
自然科学	しぜんかがく	
時速	じそく	
子孫	しそん	
死体	したい	
下書き	したがき	
下町	したまち	
自治	じち	
実感	じっかん	
湿気	しっけ	
実習	じっしゅう	
実績	じっせき	
湿度	しつど	
執筆	しっぴつ	
実物	じつぶつ	
実用	じつよう	
実力	じつりょく	
実例	じつれい	
失恋	しつれん	
指定	してい	
私鉄	してつ	
児童	じどう	
縛る	しばる	
地盤	じばん	
紙幣	しへい	
絞る	しぼる	
縞	しま	
地味	じみ	
氏名	しめい	
締切	しめきり	
締め切る	しめきる	
湿る	しめる	
社会科学	しゃかいかがく	
蛇口	じゃぐち	
弱点	じゃくてん	
車庫	しゃこ	
車掌	しゃしょう	
写生	しゃせい	
社説	しゃせつ	
車輪	しゃりん	
洒落	しゃれ	
集会	しゅうかい	
住居	じゅうきょ	
集金	しゅうきん	
集合	しゅうごう	
習字	しゅうじ	
修繕	しゅうぜん	
重体	じゅうたい	
絨毯	じゅうたん	
終点	しゅうてん	
重点	じゅうてん	
就任	しゅうにん	
周辺	しゅうへん	
重役	じゅうやく	
終了	しゅうりょう	
重量	じゅうりょう	
重力	じゅうりょく	
熟語	じゅくご	
祝日	しゅくじつ	
縮小	しゅくしょう	
受験	じゅけん	
主語	しゅご	
出勤	しゅっきん	
述語	じゅつご	
出張	しゅっちょう	
寿命	じゅみょう	
主役	しゅやく	
受話器	じゅわき	
循環	じゅんかん	
巡査	じゅんさ	
順々	じゅんじゅん	
順序	じゅんじょ	
純情	じゅんじょう	
純粋	じゅんすい	
消化	しょうか	
小学生	しょうがくせい	
将棋	しょうぎ	
蒸気	じょうき	
定規	じょうぎ	
上級	じょうきゅう	
商業	しょうぎょう	
消極的	しょうきょくてき	
賞金	しょうきん	
上下	じょうげ	
障子	しょうじ	
商社	しょうしゃ	
乗車	じょうしゃ	
上旬	じょうじゅん	
生ずる	しょうずる	
小数	しょうすう	
商店	しょうてん	
焦点	しょうてん	
消毒	しょうどく	
勝敗	しょうはい	
蒸発	じょうはつ	
賞品	しょうひん	
勝負	しょうぶ	
小便	しょうべん	
消防署	しょうぼうしょ	
正味	しょうみ	
正面	しょうめん	
消耗	しょうもう	
醤油	しょうゆ	
省略	しょうりゃく	
初級	しょきゅう	
助教授	じょきょうじゅ	
食塩	しょくえん	
職人	しょくにん	
初旬	しょじゅん	
書籍	しょせき	
食器	しょっき	
書店	しょてん	
書道	しょどう	
白髪	しらが	
知合い	しりあい	
私立	しりつ	
資料	しりょう	
汁	しる	
素人	しろうと	
芯	しん	
新幹線	しんかんせん	
真空	しんくう	
信ずる	しんずる	
心身	しんしん	
申請	しんせい	
人造	じんぞう	
寝台	しんだい	
診断	しんだん	
侵入	しんにゅう	
人文科学	じんぶんかがく	
人命	じんめい	
深夜	しんや	
森林	しんりん	
親類	しんるい	
針路	しんろ	
神話	しんわ	
酢	す	
水産	すいさん	
炊事	すいじ	
水蒸気	すいじょうき	
水素	すいそ	
垂直	すいちょく	
推定	すいてい	
水滴	すいてき	
水筒	すいとう	
随筆	ずいひつ	
水分	すいぶん	
水平	すいへい	
水平線	すいへいせん	
水曜	すいよう	
末っ子	すえっこ	
図鑑	ずかん	
杉	すぎ	
好き嫌い	すききらい	
好き好き	すきずき	
透き通る	すきとおる	
隙間	すきま	
図形	ずけい	
鈴	すず	
涼む	すずむ	
棄てる	すてる	
素直	すなお	
頭脳	ずのう	
図表	ずひょう	
住まい	すまい	
墨	すみ	
澄む	すむ	
清む	すむ	
相撲	すもう	
掏摸	すり	
刷る	する	
狡い	ずるい	
滑れる	ずれる	
寸法	すんぽう	
姓	せい	
税関	ぜいかん	
製作	せいさく	
制作	せいさく	
性質	せいしつ	
清書	せいしょ	
青少年	せいしょうねん	
整数	せいすう	
清掃	せいそう	
生存	せいぞん	
生長	せいちょう	
政党	せいとう	
生年月日	せいねんがっぴ	
性能	せいのう	
整備	せいび	
成分	せいぶん	
性別	せいべつ	
正方形	せいほうけい	
正門	せいもん	
成立	せいりつ	
西暦	せいれき	
背負う	せおう	
赤道	せきどう	
折角	せっかく	
接近	せっきん	
石鹸	せっけん	
接する	せっする	
接続	せつぞく	
瀬戸物	せともの	
迫る	せまる	
攻める	せめる	
栓	せん	
前後	ぜんご	
洗剤	せんざい	
全集	ぜんしゅう	
全身	ぜんしん	
扇子	せんす	
専制	せんせい	
先々月	せんせんげつ	
先々週	せんせんしゅう	
先祖	せんぞ	
先端	せんたん	
宣伝	せんでん	
先頭	せんとう	
全般	ぜんぱん	
扇風機	せんぷうき	
線路	せんろ	
相違	そうい	
雑巾	ぞうきん	
増減	ぞうげん	
倉庫	そうこ	
相互	そうご	
創作	そうさく	
葬式	そうしき	
造船	ぞうせん	
騒々しい	そうぞうしい	
増大	ぞうだい	
送別	そうべつ	
草履	ぞうり	
総理大臣	そうりだいじん	
送料	そうりょう	
属する	ぞくする	
続々	ぞくぞく	
速達	そくたつ	
測定	そくてい	
測量	そくりょう	
速力	そくりょく	
素質	そしつ	
祖先	そせん	
卒直	そっちょく	
具える	そなえる	
蕎麦	そば	
剃る	そる	
逸れる	それる	
揃う	そろう	
揃える	そろえる	
算盤	そろばん	
存じる	ぞんじる	
存ずる	ぞんずる	
損得	そんとく	
田ぼ	たんぼ		
退院	たいいん	
大学院	だいがくいん	
大工	だいく	
体系	たいけい	
太鼓	たいこ	
対策	たいさく	
大して	たいして	
対照	たいしょう	
大小	だいしょう	
体制	たいせい	
体積	たいせき	
大層	たいそう	
体操	たいそう	
大分	だいぶん	
大木	たいぼく	
題名	だいめい	
代名詞	だいめいし	
Ͼ立	たいりつ	
田植え	たうえ	
絶えず	たえず	
楕円	だえん	
高める	たかめる	
耕す	たがやす	
滝	たき	
炊く	たく	
焚く	たく	
蓄える	たくわえる	
竹	たけ	
助かる	たすかる	
只	ただ	
但し	ただし	
畳む	たたむ	
立ち止まる	たちどまる	
建つ	たつ	
発つ	たつ	
脱線	だっせん	
妥当	だとう	
例える	たとえる	
頼もしい	たのもしい	
足袋	たび	
溜まる	たまる	
溜息	ためいき	
溜める	ためる	
足る	たる	
段階	だんかい	
短期	たんき	
炭鉱	たんこう	
短所	たんしょ	
淡水	たんすい	
断水	だんすい	
単数	たんすう	
団地	だんち	
断定	だんてい	
短編	たんぺん	
誓う	ちかう	
地下水	ちかすい	
近々	ちかぢか	
近付ける	ちかづける	
近寄る	ちかよる	
力強い	ちからづよい	
地質	ちしつ	
知人	ちじん	
地帯	ちたい	
縮む	ちぢむ	
縮める	ちぢめる	
縮れる	ちぢれる	
地点	ちてん	
地名	ちめい	
茶色い	ちゃいろい	
着々	ちゃくちゃく	
茶碗	ちゃわん	
中間	ちゅうかん	
中旬	ちゅうじゅん	
抽象	ちゅうしょう	
中世	ちゅうせい	
中性	ちゅうせい	
中途	ちゅうと	
中年	ちゅうねん	
超過	ちょうか	
彫刻	ちょうこく	
長所	ちょうしょ	
長女	ちょうじょ	
調整	ちょうせい	
調節	ちょうせつ	
長短	ちょうたん	
頂点	ちょうてん	
長男	ちょうなん	
長方形	ちょうほうけい	
調味料	ちょうみりょう	
直後	ちょくご	
直線	ちょくせん	
直前	ちょくぜん	
直通	ちょくつう	
直流	ちょくりゅう	
貯蔵	ちょぞう	
直角	ちょっかく	
直径	ちょっけい	
散らかす	ちらかす	
散らかる	ちらかる	
散らす	ちらす	
塵紙	ちりがみ	
散る	ちる	
追加	ついか	
通貨	つうか	
通勤	つうきん	
通ずる	つうずる	
通知	つうち	
通帳	つうちょう	
通訳	つうやく	
通用	つうよう	
通路	つうろ	
付合う	つきあう	
突き当たり	つきあたり	
突き当たる	つきあたる	
月日	つきひ	
点く	つく	
突く	つく	
次ぐ	つぐ	
作る/造る	つくる	
着ける	つける	
点ける	つける	
浸ける	つける	
伝わる	つたわる	
突っ込む	つっこむ	
務める	つとめる	
努める	つとめる	
綱	つな	
繋がり	つながり	
繋がる	つながる	
繋げる	つなげる	
粒	つぶ	
潰す	つぶす	
潰れる	つぶれる	
詰まる	つまる	
積む	つむ	
爪	つめ	
艶	つや	
強気	つよき	
釣り合う	つりあう	
吊る	つる	
吊す	つるす	
出合い	であい	
手洗い	てあらい	
定員	ていいん	
定価	ていか	
低下	ていか	
定期券	ていきけん	
定休日	ていきゅうび	
停止	ていし	
停車	ていしゃ	
停電	ていでん	
出入り	でいり	
出入口	でいりぐち	
手入れ	ていれ	
出掛ける	でかける	
出来上がり	できあがり	
出来上がる	できあがる	
的確	てきかく	
適確	てきかく	
手首	てくび	
凸凹	でこぼこ	
手頃	てごろ	
手帳	てちょう	
鉄橋	てっきょう	
手続き	てつづき	
鉄砲	てっぽう	
手拭い	てぬぐい	
手前	てまえ	
出迎え	でむかえ	
出迎える	でむかえる	
照らす	てらす	
照る	てる	
展開	てんかい	
伝記	でんき	
電球	でんきゅう	
点数	てんすう	
伝染	でんせん	
電池	でんち	
点々	てんてん	
転々	てんてん	
電柱	でんちゅう	
天皇	てんのう	
電波	でんぱ	
電流	でんりゅう	
電力	でんりょく	
問い合わせ	といあわせ	
銅	どう	
統一	とういつ	
同格	どうかく	
峠	とうげ	
統計	とうけい	
動作	どうさ	
東西	とうざい	
当日	とうじつ	
投書	とうしょ	
登場	とうじょう	
灯台	とうだい	
盗難	とうなん	
当番	とうばん	
等分	とうぶん	
透明	とうめい	
灯油	とうゆ	
東洋	とうよう	
童話	どうわ	
通り掛かる	とおりかかる	
溶かす	とかす	
尖る	とがる	
溶く	とく	
退く	どく	
特殊	とくしゅ	
特色	とくしょく	
特長	とくちょう	
特定	とくてい	
特売	とくばい	
溶け込む	とけこむ	
溶ける	とける	
退ける	どける	
床の間	とこのま	
床屋	とこや	
所々	ところどころ	
都心	としん	
戸棚	とだな	
整う	ととのう	
留まる	とどまる	
飛び込む	とびこむ	
跳ぶ	とぶ	
泊める	とめる	
捕える	とらえる	
取り入れる	とりいれる	
取り消す	とりけす	
取り出す	とりだす	
採る	とる	
捕る	とる	
丼	どんぶり	
内科	ないか	
内線	ないせん	
治す	なおす	
永い	ながい	
仲直り	なかなおり	
長引く	ながびく	
中身	なかみ	
中味	なかみ	
中指	なかゆび	
仲良し	なかよし	
慰める	なぐさめる	
亡くす	なくす	
為す	なす	
謎謎	なぞなぞ	
傾らか	なだらか	
懐かしい	なつかしい	
撫でる	なでる	
斜め	ななめ	
何々	なになに	
何分	なにぶん	
生意気	なまいき	
並木	なみき	
倣う	ならう	
鳴らす	ならす	
生る	なる	
馴れる	なれる	
南極	なんきょく	
南米	なんべい	
南北	なんぼく	
煮える	にえる	
匂う	におう	
逃がす	にがす	
憎い	にくい	
憎む	にくむ	
憎らしい	にくらしい	
濁る	にごる	
虹	にじ	
日時	にちじ	
日用品	にちようひん	
日課	にっか	
日程	にってい	
鈍い	にぶい	
入社	にゅうしゃ	
女房	にょうぼう	
睨む	にらむ	
煮る	にる	
俄	にわか	
縫う	ぬう	
濡らす	ぬらす	
捩る	ねじる	
熱する	ねっする	
寝間着	ねまき	
寝巻	ねまき	
狙い	ねらい	
狙う	ねらう	
年度	ねんど	
農村	のうそん	
農産物	のうさんぶつ	
濃度	のうど	
農薬	のうやく	
能率	のうりつ	
残らず	のこらず	
載せる	のせる	
覗く	のぞく	
延ばす	のばす	
延びる	のびる	
上り	のぼり	
上る	のぼる	
糊	のり	
乗換	のりかえ	
載る	のる	
呑気	のんき	
灰色	はいいろ	
俳句	はいく	
拝見	はいけん	
売店	ばいてん	
売買	ばいばい	
這う	はう	
生える	はえる	
剥す	はがす	
秤	はかり	
量る	はかる	
測る	はかる	
吐き気	はきけ	
掃く	はく	
歯車	はぐるま	
挟まる	はさまる	
挟む	はさむ	
箸	はし	
梯子	はしご	
始めに	はじめに	
初めに	はじめに	
斜	はす	
外れる	はずれる	
肌着	はだぎ	
果して	はたして	
鉢	はち	
×	ばつ	
発揮	はっき	
発射	はっしゃ	
発想	はっそう	
発電	はつでん	
発売	はつばい	
派手	はで	
話合い	はなしあい	
話し掛ける	はなしかける	
話中	はなしちゅう	
甚だしい	はなはだしい	
花火	はなび	
花嫁	はなよめ	
放れる	はなれる	
羽根	はね	
跳ねる	はねる	
破片	はへん	
歯磨き	はみがき	
早口	はやくち	
流行る	はやる	
払い込む	はらいこむ	
払い戻す	はらいもどす	
針金	はりがね	
張り切る	はりきる	
反映	はんえい	
半径	はんけい	
判子	はんこ	
万歳	ばんざい	
判事	はんじ	
反省	はんせい	
番地	ばんち	
半島	はんとう	
日当たり	ひあたり	
日帰り	ひがえり	
比較的	ひかくてき	
日陰	ひかげ	
引受る	ひきうける	
引返す	ひきかえす	
引算	ひきざん	
引出す	ひきだす	
引き止める	ひきとめる	
卑怯	ひきょう	
引分け	ひきわけ	
髭	ひげ	
陽射	ひざし	
肘	ひじ	
引っ掛かる	ひっかかる	
筆記	ひっき	
引っ繰り返す	ひっくりかえす	
引っ繰り返る	ひっくりかえる	
引越し	ひっこし	
引っ込む	ひっこむ	
筆者	ひっしゃ	
必需品	ひつじゅひん	
人差指	ひとさしゆび	
一通り	ひととおり	
人通り	ひとどおり	
瞳	ひとみ	
一休み	ひとやすみ	
独り言	ひとりごと	
皮肉	ひにく	
日日	ひにち	
捻る	ひねる	
日の入り	ひのいり	
日の出	ひので	
響き	ひびき	
響く	ひびく	
皮膚	ひふ	
冷やす	ひやす	
美容	びよう	
表紙	ひょうし	
標識	ひょうしき	
標準	ひょうじゅん	
標本	ひょうほん	
評論	ひょうろん	
平仮名	ひらがな	
昼寝	ひるね	
広げる	ひろげる	
広さ	ひろさ	
広場	ひろば	
広々	ひろびろ	
広める	ひろめる	
便箋	びんせん	
瓶詰	びんづめ	
風船	ふうせん	
不運	ふうん	
殖える	ふえる	
深まる	ふかまる	
不規則	ふきそく	
普及	ふきゅう	
付近	ふきん	
拭く	ふく	
副詞	ふくし	
複写	ふくしゃ	
複数	ふくすう	
含める	ふくめる	
膨らます	ふくらます	
膨らむ	ふくらむ	
不潔	ふけつ	
更ける	ふける	
符号	ふごう	
夫妻	ふさい	
塞がる	ふさがる	
塞ぐ	ふさぐ	
無沙汰	ぶさた	
武士	ぶし	
部首	ぶしゅ	
襖	ふすま	
附属	ふぞく	
蓋	ふた	
不通	ふつう	
物騒	ぶっそう	
船便	ふなびん	
部品	ぶひん	
吹雪	ふぶき	
父母	ふぼ	
踏切	ふみきり	
麓	ふもと	
増やす	ふやす	
殖やす	ふやす	
振り仮名	ふりがな	
振舞う	ふるまう	
風呂敷	ふろしき	
噴火	ふんか	
分解	ぶんかい	
文芸	ぶんげい	
文献	ぶんけん	
噴水	ふんすい	
分数	ぶんすう	
文体	ぶんたい	
分布	ぶんぷ	
文房具	ぶんぼうぐ	
文脈	ぶんみゃく	
分量	ぶんりょう	
分類	ぶんるい	
閉会	へいかい	
平気	へいき	
並行	へいこう	
平日	へいじつ	
兵隊	へいたい	
平凡	へいぼん	
平野	へいや	
凹む	へこむ	
隔てる	へだてる	
別荘	べっそう	
別々	べつべつ	
編集	へんしゅう	
便所	べんじょ	
望遠鏡	ぼうえんきょう	
方角	ほうがく	
箒	ほうき	
方言	ほうげん	
坊さん	ぼうさん	
防止	ぼうし	
方針	ほうしん	
包装	ほうそう	
法則	ほうそく	
包帯	ほうたい	
膨大	ぼうだい	
庖丁	ほうちょう	
方程式	ほうていしき	
防犯	ぼうはん	
方面	ほうめん	
坊や	ぼうや	
放る	ほうる	
朗らか	ほがらか	
牧場	ぼくじょう	
牧畜	ぼくちく	
保健	ほけん	
募集	ぼしゅう	
干す	ほす	
北極	ほっきょく	
坊っちゃん	ぼっちゃん	
堀	ほり	
掘る	ほる	
彫る	ほる	
盆	ぼん	
盆地	ぼんち	
本部	ほんぶ	
本来	ほんらい	
枚数	まいすう	
毎度	まいど	
巻く	まく	
蒔く	まく	
撒く	まく	
枕	まくら	
曲げる	まげる	
摩擦	まさつ	
混ざる	まざる	
交ざる	まざる	
混じる	まじる	
交じる	まじる	
混ぜる	まぜる	
交ぜる	まぜる	
又は	または	
待合室	まちあいしつ	
待ち合わせる	まちあわせる	
街角	まちかど	
真っ暗	まっくら	
真っ黒	まっくろ	
真っ青	まっさお	
真っ先	まっさき	
真っ白	まっしろ	
祭る	まつる	
窓口	まどぐち	
纏まる	まとまる	
纏める	まとめる	
真似る	まねる	
間も無く	まもなく	
円い	まるい	
稀	まれ	
回り道	まわりみち	
満員	まんいん	
満点	まんてん	
見送る	みおくる	
見下ろす	みおろす	
見掛け	みかけ	
三日月	みかづき	
岬	みさき	
店屋	みせや	
見出し	みだし	
道順	みちじゅん	
見付かる	みつかる	
見付ける	みつける	
見直す	みなおす	
見慣れる	みなれる	
醜い	みにくい	
実る	みのる	
身分	みぶん	
見本	みほん	
見舞う	みまう	
未満	みまん	
名字	みょうじ		
診る	みる	
民間	みんかん	
民謡	みんよう	
向う	むかう	
剥く	むく	
無限	むげん	
無地	むじ	
蒸し暑い	むしあつい	
矛盾	むじゅん	
蒸す	むす	
無数	むすう	
紫	むらさき	
群れ	むれ	
姪	めい	
名作	めいさく	
名刺	めいし	
名詞	めいし	
名所	めいしょ	
命ずる	めいずる	
迷信	めいしん	
名物	めいぶつ	
銘々	めいめい	
目上	めうえ	
恵まれる	めぐまれる	
巡る	めぐる	
目指す	めざす	
目覚し	めざまし	
目下	めした	
目印	めじるし	
目立つ	めだつ	
目安	めやす	
免税	めんぜい	
面積	めんせき	
面接	めんせつ	
面倒臭い	めんどうくさい	
儲かる	もうかる	
儲ける	もうける	
申し訳ない	もうしわけない	
木材	もくざい	
目次	もくじ	
潜る	もぐる	
餅	もち	
元々	もともと	
物置	ものおき	
物語る	ものがたる	
物差し	ものさし	
物凄い	ものすごい	
揉む	もむ	
燃やす	もやす	
催し	もよおし	
盛る	もる	
問答	もんどう	
夜間	やかん	
薬缶	やかん	
役者	やくしゃ	
役所	やくしょ	
訳す	やくす	
役人	やくにん	
薬品	やくひん	
役目	やくめ	
火傷	やけど	
夜行	やこう	
矢印	やじるし	
薬局	やっきょく	
家主	やぬし	
破く	やぶく	
破れる	やぶれる	
軟らかい	やわらかい	
遊園地	ゆうえんち	
夕刊	ゆうかん	
友好	ゆうこう	
郵送	ゆうそう	
夕立	ゆうだち	
夕日	ゆうひ	
悠々	ゆうゆう	
有料	ゆうりょう	
浴衣	ゆかた	
湯気	ゆげ	
輸血	ゆけつ	
輸送	ゆそう	
油断	ゆだん	
湯飲み	ゆのみ	
緩い	ゆるい	
溶岩	ようがん	
容器	ようき	
用語	ようご	
要旨	ようし	
幼児	ようじ	
容積	ようせき	
幼稚	ようち	
幼稚園	ようちえん	
用途	ようと	
洋品店	ようひんてん	
養分	ようぶん	
羊毛	ようもう	
漸く	ようやく	
要領	ようりょう	
欲張り	よくばり	
余計	よけい	
汚す	よごす	
寄せる	よせる	
余所	よそ	
四つ角	よつかど	
酔っ払い	よっぱらい	
予備	よび	
呼び掛ける	よびかける	
呼び出す	よびだす	
蘇る	よみがえる	
因る	よる	
慶び	よろこび	
慶ぶ	よろこぶ	
来日	らいにち	
落第	らくだい	
欄	らん	
乱暴	らんぼう	
理科	りか	
利害	りがい	
略す	りゃくす	
流域	りゅういき	
寮	りょう	
両側	りょうがわ	
漁師	りょうし	
領事	りょうじ	
領収	りょうしゅう	
臨時	りんじ	
留守番	るすばん	
例外	れいがい	
零点	れいてん	
冷凍	れいとう	
列島	れっとう	
煉瓦	れんが	
連合	れんごう	
蝋燭	ろうそく	
録音	ろくおん	
論ずる	ろんずる	
和英	わえい	
分る	わかる	
分かれる	わかれる	
若々しい	わかわかしい	
湧く	わく	
詫びる	わびる	
和服	わふく	
割算	わりざん	
割と	わりと	
割引	わりびき	
椀	わん	
碗	わん	