会	meeting/meet/party/association/interview/join	
同	same/agree/equal	
事	matter/thing/fact/business/reason/possibly	
自	oneself	
社	company/firm/office/association/shrine	
発	discharge/departure/publish/emit/start from/disclose	
者	someone/person	
地	ground/earth	
業	business/vocation/arts/performance	
方	direction/person/alternative	
新	new	
場	location/place	
員	employee/member/number/the one in charge	
立	stand up	
開	open/unfold/unseal	
手	hand	
力	power/strong/strain/bear up/exert	
問	question/ask/problem	
代	substitute/change/convert/replace/period/age/generation/charge/rate/fee	
明	bright/light	
動	move/motion/change/confusion/shift/shake	
京	capital/10**16	
目	eye/class/look/insight/experience/care/favor	
通	traffic/pass through/avenue/commute/counter for letters	
言	say	
理	logic/arrangement/reason/justice/truth	
体	body/substance/object/reality/counter for images	
田	rice field/rice paddy	
主	lord/chief/master/main thing/principal	
題	topic/subject	
意	idea/mind/heart/taste/thought/desire/care/liking	
不	negative/non-/bad/ugly/clumsy	
作	make/production/prepare/build	
用	utilize/business/service/use/employ	
度	degrees/occurrence/time/counter for occurrences	
強	strong	
公	public/prince/official/governmental	
持	hold/have	
野	plains/field/rustic/civilian life	
以	by means of/because/in view of/compared with	
思	think	
家	house/home	
世	generation/world/society/public	
多	many/frequent/much	
正	correct/justice/righteous/10**40	
安	relax/cheap/low/quiet/rested/contented/peaceful	
院	Inst./institution/temple/mansion/school	
心	heart/mind/spirit	
界	world	
教	teach/faith/doctrine	
文	sentence/literature/style/art/decoration/figures/plan	
元	beginning/former time/origin	
重	heavy/heap up/pile up/nest of boxes/-fold	
近	near/early/akin/tantamount	
考	consider/think over	
画	brush-stroke/picture	
海	sea/ocean	
売	sell	
知	know/wisdom	
道	road-way/street/district/journey/course/moral/teachings	
集	gather/meet/congregate/swarm/flock	
別	separate/branch off/diverge/fork/another/extra/specially	
物	thing/object/matter	
使	use	
品	goods/refinement/dignity/article/counter for meal courses	
計	plot/plan/scheme/measure	
死	death/die	
特	special	
私	private/I/me	
始	commence/begin	
朝	morning/dynasty/regime/epoch/period/(North) Korea	
運	carry/luck/destiny/fate/lot/transport/progress/advance	
終	end/finish	
台	pedestal/a stand/counter for machines and vehicles	
広	wide/broad/spacious	
住	dwell/reside/live/inhabit	
真	true/reality/Buddhist sect	
有	possess/have/exist/happen/occur/approx	
口	mouth	
少	few/little	
町	village/town/block/street	
料	fee/materials	
工	craft/construction	
建	build	
空	empty/sky/void/vacant/vacuum	
急	hurry/emergency/sudden/steep	
止	stop/halt	
送	escort/send	
切	cut/cutoff/be sharp	
転	revolve/turn around/change	
研	polish/study of/sharpen	
足	leg/foot/be sufficient/counter for pairs of footwear	
究	research/study	
楽	music/comfort/ease	
起	rouse/wake up/get up	
着	don/arrive/wear/counter for suits of clothing	
店	store/shop	
病	ill/sick	
質	substance/quality/matter/temperament	
待	wait/depend on	
試	test/try/attempt/experiment/ordeal	
族	tribe/family	
銀	silver	
早	early/fast	
映	reflect/reflection/projection	
親	parent/intimacy/relative/familiarity/dealer (cards)	
験	verification/effect/testing	
英	England/English	
医	doctor/medicine	
仕	attend/doing/official/serve	
去	gone/past/quit/leave/elapse/eliminate/divorce	
味	flavor/taste	
写	copy/be photographed/describe	
字	character/letter/word/section of village	
答	solution/answer	
夜	night/evening	
音	sound/noise	
注	pour/irrigate/shed (tears)/flow into/concentrate on/notes/comment/annotate	
帰	homecoming/arrive at/lead to/result in	
古	old	
歌	song/sing	
買	buy	
悪	bad/vice/rascal/false/evil/wrong	
図	map/drawing/plan/unexpected/accidentally	
週	week	
室	room/apartment/chamber/greenhouse/cellar	
歩	walk/counter for steps	
風	wind/air/style/manner	
紙	paper	
黒	black	
花	flower	
春	springtime/spring (season)	
赤	red	
青	blue/green	
館	building/mansion/large building/palace	
屋	roof/house/shop/dealer/seller	
色	color	
走	run	
秋	autumn	
夏	summer	
習	learn	
駅	station	
洋	ocean/western style	
旅	trip/travel	
服	clothing/admit/obey/discharge	
夕	evening	
借	borrow/rent	
曜	weekday	
飲	drink/smoke/take	
肉	meat	
貸	lend	
堂	public chamber/hall	
鳥	bird/chicken	
飯	meal/boiled rice	
勉	exertion	
冬	winter	
昼	daytime/noon	
茶	tea	
弟	younger brother/faithful service to elders	
牛	cow	
魚	fish	
兄	elder brother/big brother	
犬	dog	
妹	younger sister	
姉	elder sister	
漢	Sino-/China	