間	あいだ	
合う	あう	
上る	あがる	
赤ん坊	あかんぼう	
空く	あく	
浅い	あさい	
味	あじ	
明日	あす	
遊び	あそび	
集る	あつまる	
集める	あつめる	
謝る	あやまる	
安心	あんしん	
安全	あんぜん	
案内	あんない	
以下	いか	
以外	いがい	
医学	いがく	
生きる	いきる	
意見	いけん	
石	いし	
以上	いじょう	
急ぐ	いそぐ	
致す	いたす	
一度	いちど	
一生懸命	いっしょうけんめい	
糸	いと	
以内	いない	
田舎	いなか	
祈る	いのる	
植える	うえる	
受付	うけつけ	
受ける	うける	
動く	うごく	
打つ	うつ	
美しい	うつくしい	
写す	うつす	
移る	うつる	
腕	うで	
裏	うら	
売り場	うりば	
運転	うんてん	
運転手	うんてんしゅ	
運動	うんどう	
枝	えだ	
選ぶ	えらぶ	
遠慮	えんりょ	
お祝い	おいわい	
億	おく	
屋上	おくじょう	
贈り物	おくりもの	
送る	おくる	
遅れる	おくれる	
起す	おこす	
行う	おこなう	
怒る	おこる	
押し入れ	おしいれ	
お嬢さん	おじょうさん	
お宅	おたく	
落る	おちる	
夫	おっと	
音	おと	
落す	おとす	
踊り	おどり	
踊る	おどる	
驚く	おどろく	
お祭り	おまつり	
お見舞い	おみまい	
お土産	おみやげ	
思い出す	おもいだす	
思う	おもう	
表	おもて	
親	おや	
下りる	おりる	
折る	おる	
お礼	おれい	
折れる	おれる	
終わり	おわり	
海岸	かいがん	
会議	かいぎ	
会議室	かいぎしつ	
会場	かいじょう	
会話	かいわ	
帰り	かえり	
変える	かえる	
科学	かがく	
鏡	かがみ	
掛ける	かける	
飾る	かざる	
火事	かじ	
堅/硬/固い	かたい	
形	かたち	
片付ける	かたづける	
課長	かちょう	
勝つ	かつ	
家内	かない	
悲しい	かなしい	
必ず	かならず	
お金持ち	かねもち/おかねもち	
彼女	かのじょ	
壁	かべ	
髪	かみ	
噛む	かむ	
通う	かよう	
彼	かれ	
彼ら	かれら	
乾く	かわく	
代わり	かわり	
変わる	かわる	
考える	かんがえる	
関係	かんけい	
看護婦	かんごふ	
簡単	かんたん	
気	き	
機会	きかい	
危険	きけん	
聞こえる	きこえる	
汽車	きしゃ	
技術	ぎじゅつ	
季節	きせつ	
規則	きそく	
絹	きぬ	
厳しい	きびしい	
気分	きぶん	
決る	きまる	
君	きみ	
決める	きめる	
気持ち	きもち	
着物	きもの	
客	きゃく	
急	きゅう	
急行	きゅうこう	
教育	きょういく	
教会	きょうかい	
競争	きょうそう	
興味	きょうみ	
近所	きんじょ	
具合	ぐあい	
空気	くうき	
空港	くうこう	
草	くさ	
首	くび	
雲	くも	
比べる	くらべる	
暮れる	くれる	
毛	け	
計画	けいかく	
経験	けいけん	
経済	けいざい	
警察	けいさつ	
景色	けしき	
消しゴム	けしゴム	
下宿	げしゅく	
決して	けっして	
原因	げんいん	
研究	けんきゅう	
研究室	けんきゅうしつ	
見物	けんぶつ	
子	こ	
郊外	こうがい	
講義	こうぎ	
工業	こうぎょう	
高校	こうこう	
高校生	こうこうせい	
工場	こうじょう	
校長	こうちょう	
交通	こうつう	
講堂	こうどう	
高等学校	こうとうがっこう	
公務員	こうむいん	
国際	こくさい	
心	こころ	
御主人	ごしゅじん	
故障	こしょう	
ご存じ	ごぞんじ	
答	こたえ	
小鳥	ことり	
細かい	こまかい	
込む	こむ	
米	こめ	
怖い	こわい	
壊す	こわす	
壊れる	こわれる	
今度	こんど	
今夜	こんや	
最近	さいきん	
最後	さいご	
最初	さいしょ	
坂	さか	
探す	さがす	
下る	さがる	
盛ん	さかん	
下げる	さげる	
差し上げる	さしあげる	
寂しい	さびしい	
さ来月	さらいげつ	
さ来週	さらいしゅう	
騒ぐ	さわぐ	
触る	さわる	
産業	さんぎょう	
残念	ざんねん	
市	し	
字	じ	
試合	しあい	
仕方	しかた	
試験	しけん	
事故	じこ	
地震	じしん	
時代	じだい	
下着	したぎ	
支度	したく	
失敗	しっぱい	
辞典	じてん	
品物	しなもの	
島	しま	
市民	しみん	
事務所	じむしょ	
社会	しゃかい	
社長	しゃちょう	
自由	じゆう	
習慣	しゅうかん	
住所	じゅうしょ	
柔道	じゅうどう	
十分	じゅうぶん	
出席	しゅっせき	
出発	しゅっぱつ	
趣味	しゅみ	
準備	じゅんび	
紹介	しょうかい	
小学校	しょうがっこう	
小説	しょうせつ	
招待	しょうたい	
承知	しょうち	
将来	しょうらい	
食事	しょくじ	
食料品	しょくりょうひん	
女性	じょせい	
知らせる	しらせる	
調べる	しらべる	
人口	じんこう	
神社	じんじゃ	
親切	しんせつ	
心配	しんぱい	
新聞社	しんぶんしゃ	
水泳	すいえい	
水道	すいどう	
数学	すうがく	
過ぎる	すぎる	
凄い	すごい	
進む	すすむ	
捨てる	すてる	
砂	すな	
滑る	すべる	
隅	すみ	
済む	すむ	
生活	せいかつ	
生産	せいさん	
政治	せいじ	
西洋	せいよう	
世界	せかい	
席	せき	
説明	せつめい	
背中	せなか	
世話	せわ	
線	せん	
戦争	せんそう	
先輩	せんぱい	
相談	そうだん	
育てる	そだてる	
卒業	そつぎょう	
祖父	そふ	
祖母	そぼ	
退院	たいいん	
大学生	だいがくせい	
大事	だいじ	
大体	だいたい	
大分	だいぶ	
台風	たいふう	
倒れる	たおれる	
確か	たしか	
足す	たす	
訪ねる	たずねる	
尋ねる	たずねる	
正しい	ただしい	
畳	たたみ	
立てる	たてる	
建てる	たてる	
例えば	たとえば	
棚	たな	
楽しみ	たのしみ	
楽む	たのしむ	
為	ため	
足りる	たりる	
男性	だんせい	
暖房	だんぼう	
血	ち	
力	ちから	
注意	ちゅうい	
中学校	ちゅうがっこう	
注射	ちゅうしゃ	
駐車場	ちゅうしゃじょう	
地理	ちり	
捕まえる	つかまえる	
付く	つく	
漬ける	つける	
都合	つごう	
伝える	つたえる	
続く	つづく	
続ける	つづける	
包む	つつむ	
妻	つま	
釣る	つる	
連れる	つれる	
丁寧	ていねい	
適当	てきとう	
手伝う	てつだう	
手袋	てぶくろ	
寺	てら	
点	てん	
店員	てんいん	
天気予報	てんきよほう	
電灯	でんとう	
電報	でんぽう	
展覧会	てんらんかい	
都	と	
道具	どうぐ	
動物園	どうぶつえん	
遠く	とおく	
通る	とおる	
特に	とくに	
特別	とくべつ	
途中	とちゅう	
特急	とっきゅう	
届ける	とどける	
泊まる	とまる	
止める	とめる	
取り替える	とりかえる	
泥棒	どろぼう	
直す	なおす	
直る	なおる	
治る	なおる	
中々	なかなか	
泣く	なく	
無くなる	なくなる	
投げる	なげる	
亡くなる	なくなる	
鳴る	なる	
慣れる	なれる	
二階建て	にかいだて	
苦い	にがい	
逃げる	にげる	
入院	にゅういん	
日記	にっき	
入学	にゅうがく	
似る	にる	
人形	にんぎょう	
盗む	ぬすむ	
塗る	ぬる	
熱	ねつ	
寝坊	ねぼう	
眠い	ねむい	
眠る	ねむる	
残る	のこる	
乗り換える	のりかえる	
乗り物	のりもの	
葉	は	
場合	ばあい	
倍	ばい	
拝見	はいけん	
歯医者	はいしゃ	
運ぶ	はこぶ	
始める	はじめる	
場所	ばしょ	
恥ずかしい	はずかしい	
発音	はつおん	
花見	はなみ	
林	はやし	
払う	はらう	
番組	ばんぐみ	
反対	はんたい	
日	ひ	
火	ひ	
冷える	ひえる	
光	ひかり	
光る	ひかる	
引き出し	ひきだし	
引き出す	ひきだす	
飛行場	ひこうじょう	
久しぶり	ひさしぶり	
美術館	びじゅつかん	
非常に	ひじょうに	
引っ越す	ひっこす	
必要	ひつよう	
開く	ひらく	
昼間	ひるま	
昼休み	ひるやすみ	
拾う	ひろう	
増える	ふえる	
深い	ふかい	
複雑	ふくざつ	
復習	ふくしゅう	
部長	ぶちょう	
普通	ふつう	
太る	ふとる	
布団	ふとん	
舟	ふね	
不便	ふべん	
踏む	ふむ	
降り出す	ふりだす	
文化	ぶんか	
文学	ぶんがく	
文法	ぶんぽう	
別	べつ	
変	へん	
返事	へんじ	
貿易	ぼうえき	
放送	ほうそう	
法律	ほうりつ	
僕	ぼく	
星	ほし	
翻訳	ほんやく	
参る	まいる	
負ける	まける	
間違える	まちがえる	
間に合う	まにあう	
周り	まわり	
回る	まわる	
漫画	まんが	
真中	まんなか	
見える	みえる	
湖	みずうみ	
味噌	みそ	
見つかる	みつかる	
見つける	みつける	
皆	みな	
港	みなと	
向かう	むかう	
迎える	むかえる	
昔	むかし	
虫	むし	
息子	むすこ	
娘	むすめ	
無理	むり	
召し上がる	めしあがる	
珍しい	めずらしい	
申し上げる	もうしあげる	
申す	もうす	
戻る	もどる	
木綿	もめん	
森	もり	
焼く	やく	
約束	やくそく	
役に立つ	やくにたつ	
焼ける	やける	
優しい	やさしい	
痩せる	やせる	
止む	やむ	
柔らかい	やわらかい	
湯	ゆ	
輸出	ゆしゅつ	
輸入	ゆにゅう	
指	ゆび	
指輪	ゆびわ	
夢	ゆめ	
揺れる	ゆれる	
用	よう	
用意	ようい	
用事	ようじ	
汚れる	よごれる	
予習	よしゅう	
予定	よてい	
予約	よやく	
寄る	よる	
喜ぶ	よろこぶ	
理由	りゆう	
利用	りよう	
両方	りょうほう	
旅館	りょかん	
留守	るす	
冷房	れいぼう	
歴史	れきし	
連絡	れんらく	
沸かす	わかす	
別れる	わかれる	
沸く	わく	
訳	わけ	
忘れ物	わすれもの	
笑う	わらう	
割合	わりあい	
割れる	われる	
泳ぎ方	およぎかた	